No	From	To	Tokens	TokenBalance	Block	TxIndex	TxHash
0	0x0000000000000000000000000000000000000000	0xeedda0f22244b7af24a2462907bc6bc047a23cd0	9302486	9302486	3912091	0	0x3904a45d46ee2174573b641f5ee09b77a8097a6a54dc9370fc1f9c4634384a65
1	0x0000000000000000000000000000000000000000	0x8fd7bf2142cc3819caf93cb7f282b57becbf8ba9	370997	9673483	3912104	0	0xb862be4db01f1c7ddb3d7fd371d6755348659f23f15911bd375a747c36c3bd2c
2	0x0000000000000000000000000000000000000000	0xf6336aaf4f95e80e19c068ec4365bf8dbc940e6f	2166717	11840200	3912107	0	0xffc1365ffed6d8190b815428049bff2575ffd85aee54508569f5905901c9a75a
3	0x0000000000000000000000000000000000000000	0x32d89823383a56b43ea159aa88a8c4fc3fbd4864	431377	12271577	3912152	0	0x8eae50f3184b3d8b434173fa8a69635b44684af135109bb971e5715498a61ef7
4	0x0000000000000000000000000000000000000000	0x990a2d172398007fcbd5078d84696bdd8ccdf7b2	314646	12586223	3912159	0	0x74f992f76cbd97fe09e0be53c1b9175e99084cba981f567002ca1029c78ad530
5	0x0000000000000000000000000000000000000000	0x8a53ee33d77371bacdc76cae6632c23495f669d7	478.68	12586701.68	3913144	26	0xb7b1084136431bb4956414025a71e710b4f57363ba2aaeabd2f4dac881866045
6	0x0000000000000000000000000000000000000000	0xa6bc6b41fc360364af6c2138ad9f1e4005523532	957.36	12587659.04	3913144	38	0xec7f08d8e2e47b20248559e97bc1b7f702342b5c360f1b0b8c804f16b41d003f
7	0x0000000000000000000000000000000000000000	0x3b150851de69e672ec79a60a3df4663985496e14	478.68	12588137.72	3913144	78	0xd13f01385b2df8b30b17472addcce102039fd68405448e9037cf6b582ac0ae4b
8	0x0000000000000000000000000000000000000000	0x03474b39c921adbfaa80aad93a3069b5cd2f7958	454.746	12588592.466	3913146	0	0x5669843d5f32d5c621c91dad7e1992ab08836acb797fad67d7c413371c4c713d
9	0x0000000000000000000000000000000000000000	0x9db5b9e37d8e8827f5f49839821cb16db555d5f6	1005.228	12589597.694	3913146	8	0x8489065d86f1ae84ba26cc5c1387176e3fc78207857801004ed680c0d9b013ad
10	0x0000000000000000000000000000000000000000	0xc5cc4644c3b9ccca30c3e9a2d21651b795a96a89	1436.04	12591033.734	3913147	7	0x1d4464d94dbbb67532314819f52ffe80dd4bb10e36a2fb210384c1bb351daf5c
11	0x0000000000000000000000000000000000000000	0x83df74e7114079b98e69089edcdc8de377fb7cb0	47.868	12591081.602	3913147	11	0xb317ad5181c525990dec1d6eacdf776aaf053f81723222da86f44f5d5f61ebf2
12	0x0000000000000000000000000000000000000000	0xa81b019fd55ce3a676c4dfa1ae8a1ed9f48ed675	1292.436	12592374.038	3913147	31	0xc5844863c0a9cd07c3fed820ad4b03f7edf091b4e38d65f2f8a42df3b7a6f20e
13	0x0000000000000000000000000000000000000000	0xbc7a323e87f2820ac55d15c59db31edbdd176da6	957.36	12593331.398	3913148	1	0x7ac3c2d438ddd57495ec9694814a7a75bc5f1409f097c4f8edd90ffef1a10b25
14	0x0000000000000000000000000000000000000000	0x7b5e7fa8e19db6f3488d064c5f0ae519f439a643	191472	12784803.398	3913148	2	0x7ec728913435909a164f463dead505ea96bf59d25db1df4cb1fdd77b863e9785
15	0x0000000000000000000000000000000000000000	0x93750ddf10aee0f883cec77769606a6bf97efe70	718.02	12785521.418	3913148	3	0x8091a201c9da5a98c16f4b414f83eb932aba71661bd3bab0a420774e878b711f
16	0x0000000000000000000000000000000000000000	0x7e0e15ed146d0ae84d7779f82b650523d5c4ac01	142.763416088209497283	12785664.181416088209497283	3913148	4	0x88f48adc1aed89c459831ddf7585a1ca83e2f53e4ecaf13ef582a82700df3151
17	0x0000000000000000000000000000000000000000	0x25352537c8f887eb55ea0d9dfe4b888dff494f7d	1436.04	12787100.221416088209497283	3913149	4	0x066978f035bb97e488fc49e52d23f55e4690f089a7dc4bb1b6ad3e81b5a499d4
18	0x0000000000000000000000000000000000000000	0x5075a11da5604882c6d5d332bde32c29572a7854	143.604	12787243.825416088209497283	3913149	5	0x31b483bd3824dcdfaee1c7d7fe84ed07a8b04f867d7cb0e5ef4f3024521f551a
19	0x0000000000000000000000000000000000000000	0x8e72780406cb9b992b7bc8ff0308dc63510f10a1	478.68	12787722.505416088209497283	3913149	6	0x4d27102ec626993df662c0bf5a6f82a72e573531784422af80ef3beb7aa71ccc
20	0x0000000000000000000000000000000000000000	0x3fbcc04b418172b9803446b5a0fdced18903d48b	2393.4	12790115.905416088209497283	3913149	8	0xeb8a576f5cd9df3c9d48d0f606ba98325819ebe778f3cbbb8d9e0714b1d8c937
21	0x0000000000000000000000000000000000000000	0x83bad39f067ef72e354f2ea9d318eaad381a7f15	478.68	12790594.585416088209497283	3913149	13	0x962d8c4eccb7badbd33f71a4929f91431e219fad6a5f22f6177a18ba304e9563
22	0x0000000000000000000000000000000000000000	0xfc3c8111c7947e07a45b6c8d3fa4d60e3c2acb6a	7180.2	12797774.785416088209497283	3913149	14	0xfcea395abc7d2510ba20b8155ee73655fe2b930a08bd14a4cf41112587bac7af
23	0x0000000000000000000000000000000000000000	0x38294068f8958e0aa02588f7b878b38bb31b49af	71.802	12797846.587416088209497283	3913149	30	0x7244ad2e2f6d7dfeebf6dd289689567549679b07c44f4b7d6c3108e6a6c1ed24
24	0x0000000000000000000000000000000000000000	0x870b140e7de192dc1538a33d0c359b70ff2c3292	4786.8	12802633.387416088209497283	3913150	1	0x76d2318442d78e80441ea697134c12ae9189a60e732dc9ce4bc44053dba62777
25	0x0000000000000000000000000000000000000000	0x62895b65f36bddf1373b363dbd7f7696e0fd2ced	14360.4	12816993.787416088209497283	3913150	2	0x1ef61d15adf3c5e5fb75f71457348ed6e8a7dd6e38c8fb4e7a4fa7cf600ec5f4
26	0x0000000000000000000000000000000000000000	0xa509ee3ba15a34f503237723569492d7b0e8fd06	9573.6	12826567.387416088209497283	3913150	3	0x21c62a008311e8874b9a9188064bb2cebfd433bb8c45cddda110a01a7641044a
27	0x0000000000000000000000000000000000000000	0x394f7953688191c5d812a4135a7881d74c5f64b1	19147.2	12845714.587416088209497283	3913150	4	0x22602fd58c2b53a6b7b901fcecd442921b7ff9ff824a100384201eb25a873f0d
28	0x0000000000000000000000000000000000000000	0x89a94b48b21d3b5f959305643d3c71dc88cc7fbc	1627.512	12847342.099416088209497283	3913150	5	0x348f4ac0428b44412f08aa27a081e1750493520d9ebb21b1cdaa3ce3b3eca7b0
29	0x0000000000000000000000000000000000000000	0xbb1f1a28e6d86c296864209a6071023d45180ae6	1436.04	12848778.139416088209497283	3913150	6	0x3f9363eed1b8395332e3bbc813e9f603a3472c03880bd258c794311d5b30cbe6
30	0x0000000000000000000000000000000000000000	0xd6b7695bc74e2c950eb953316359eab283c5bda8	4786.8	12853564.939416088209497283	3913150	7	0x4929458fbf08438fc8726cd8e7503053ac7a0b679594aca4536ef8abb07debc0
31	0x0000000000000000000000000000000000000000	0x0f934a2123a2b510522590599eb9bec66c89e64b	2872.71795215376	12856437.657368241969497283	3913150	9	0x4c382d3cda16dd6f2617a10b112b180745bb433ad46c7b93617d61ecc712bdfe
32	0x0000000000000000000000000000000000000000	0xb035c904c0770759369eb7432691a80e30df9c93	957.36	12857395.017368241969497283	3913150	10	0x57a9a3a53d61a7a03206eddd68ee85956958931ea9b222a0ac5807de4612cfdc
33	0x0000000000000000000000000000000000000000	0xc7d7f6df2872eb0a2fc69251e8cc7d2876ec1b8d	799.3956	12858194.412968241969497283	3913150	11	0x5c663fde03d2116f6294891e5b822a3b9d20cabb5a98e6f540d1733296b9fefb
34	0x0000000000000000000000000000000000000000	0x92a8f4c470e2c243e48c14709dda9009be4d5310	957.36	12859151.772968241969497283	3913150	12	0x61262d336b839fddedb073b2aaedf8705df4775bee0dd8473890f77be8ff0c46
35	0x0000000000000000000000000000000000000000	0x4ae6a8a28c87b75e935a90d6128f2649c969c0d8	239.34	12859391.112968241969497283	3913150	13	0x64544f3a5278060f31cdeec767189a51137285100c98816ce453c939f842004d
36	0x0000000000000000000000000000000000000000	0x00a7ea77c5412bfc0c4e3a2991222daa56801699	4786.8	12864177.912968241969497283	3913150	14	0x6663f580f8357913dd048d197cdacb5b4a69855581239c9eb1524163d1c12b92
37	0x0000000000000000000000000000000000000000	0x6675a5b92bf2316769ca3d80ddbb656d2cf9af9b	1914.72	12866092.632968241969497283	3913150	15	0x730d0df040d9cf895d6e1572d01be9fd24b63fb1b769f17bd318d11eebb6bfc6
38	0x0000000000000000000000000000000000000000	0x5926fe867e951386ef17474e8eb713f17095b663	4547.46	12870640.092968241969497283	3913150	17	0xc692f1751797eae22ae49b346475c2bfad51ec6a9d8dd72a81136855a5ba8c81
39	0x0000000000000000000000000000000000000000	0x31b3233acfa550584d38ba94dd037c4d8b04f074	478.68	12871118.772968241969497283	3913150	18	0xccdbfe1b766a91e06738f8fc32098b08a89b5e49d98a9997ecbff6691ccd43d0
40	0x0000000000000000000000000000000000000000	0xfcc5c1f3182dd4c3628de14d8a2c070a79e5e44f	4643.196	12875761.968968241969497283	3913150	19	0xd2188a7c9280bf5eaad0c20d74d015c29d37ecd3bdf6fa087ca6800629e09542
41	0x0000000000000000000000000000000000000000	0x8e764e690b3b25bd3e8b2714c8f4e06e7e0416c8	1795.05	12877557.018968241969497283	3913150	20	0xd306dc2b8b14308fbf832e9b66e832138d265fdd20b044e838ab150a3a69b3fe
42	0x0000000000000000000000000000000000000000	0x6732f7bec0e6ce62f7edfcd7448cfb2947e6526b	468.06859016712	12878025.087558409089497283	3913150	22	0xdffd60145575492948068db114b8a8107075371e7b9f45a2765db393739b7b0e
43	0x0000000000000000000000000000000000000000	0x700a2ae2e1ebbf33a38763ed9ab73fc0479552c2	1436.04	12879461.127558409089497283	3913150	23	0xefdec78bc7d1870aa8ffb61241b542e1a440802b83b59847c736c73ba94d3a08
44	0x0000000000000000000000000000000000000000	0x3eb244eaa617cffe19d0368ef1a140230e36207b	52.6548	12879513.782358409089497283	3913150	24	0x60d7b790bea247a8065e980cde72e8891bf85161b2aa5a4ebc7c505e7dbfd20a
45	0x0000000000000000000000000000000000000000	0x8a4de532e3364dbba3b555817dc92b48d7064c86	2393.4	12881907.182358409089497283	3913150	30	0x2256fe94013652732dee7e697d045170b2ea369c300db327ae230abdf1f6364b
46	0x0000000000000000000000000000000000000000	0xaf302aa751058797c6ab5249cb83547a6357763a	4786.8	12886693.982358409089497283	3913150	33	0x39bf633186cf564c1c1af51affb32666c343f173fb2333a30775b68be9209b36
47	0x0000000000000000000000000000000000000000	0x0088e8a7bef4ba089c9efc9f07775e3f91b868e7	9573.6	12896267.582358409089497283	3913150	34	0x60efeae43000feb295a8af5bac0be4bb8bff1a2289a89ce22c3aa8bd48d613ec
48	0x0000000000000000000000000000000000000000	0x708b6b354fb7e8a2beab12fb391cfbe6a6a83085	2393.4	12898660.982358409089497283	3913150	35	0x8ee1e3fa95c75c575389081f9a09bf51083de8dcd76b44c84dde689daa2b114e
49	0x0000000000000000000000000000000000000000	0xa7fc01ff59f917db3d77b07ad24bacfcd1943cff	16753.8	12915414.782358409089497283	3913150	42	0x37979dc5f8a3c1364134f55e6b559c0fb8d1c863321cb31adaf8d921173cefcf
50	0x0000000000000000000000000000000000000000	0xa5b5f3d06b2026892fd6b595e80009282ee56c2d	2393.4	12917808.182358409089497283	3913150	49	0xa72f0a13ab0c9fa94d2dfe287608fb686d3374fdab3b463bccde845a6c5c50ea
51	0x0000000000000000000000000000000000000000	0x487088b1e36dc17f5e3c7739b08e8d3c3dac7ff1	95.736	12917903.918358409089497283	3913150	59	0x19061015d85705d3d414402162e2becdd721e69aae2360909a35081978b33cb0
52	0x0000000000000000000000000000000000000000	0xad5220c1afc74f861739b31b3d63532ad1d3ea85	70002.1632	12987906.081558409089497283	3913152	0	0x99d863842f157bbbff5e5afde60b54fe02cc61d0c45f107b32c292797ce62393
53	0x0000000000000000000000000000000000000000	0x5e8b70b5215c6842a9d4f38fdc4e0dfcec8f2249	2393.4	12990299.481558409089497283	3913152	1	0x03d0f09f3c4c571b56da8148aee52bfb84720f7b06f5d6dcfbb196b9c5be4652
54	0x0000000000000000000000000000000000000000	0xda1b2aeac0196d39658186604609fff185e1774d	1249.3548	12991548.836358409089497283	3913152	2	0x55cb03f071452b46b0014fd0885922a36dc858dd7db5f4487ef5537467dbb10c
55	0x0000000000000000000000000000000000000000	0xdf7c3e465f886238925472c4b4b92eeab3a10877	4786.8	12996335.636358409089497283	3913152	3	0x9bfb59c149607e53baec1f14aa7c8aaa254df94ae7fdb92ef662eb68caaa7a8b
56	0x0000000000000000000000000000000000000000	0xa7c8db7920e89b9388686c3c06e0824e6a2abaa8	952.5732	12997288.209558409089497283	3913152	4	0xb1ad03b1b6c3e9828e496f941da49a86e2b0e6f9eb8b184949ea5ffe1f4b6e01
57	0x0000000000000000000000000000000000000000	0xb464dab7a2b173a22645bdb98b6aa4eb6abbe45c	10526.1732	13007814.382758409089497283	3913152	5	0xb4b93c5a880a30810beef64a865579f1aa8c742c8f70e265c1179a8d7f71cfb2
58	0x0000000000000000000000000000000000000000	0x4105b4343f4c52cea24d2cbda25b714c10bd0fc4	3925.176	13011739.558758409089497283	3913152	7	0x62af5984f8ff3a48c105873c9361e14cc42c3a499905eb504df7b3926c9b46bc
59	0x0000000000000000000000000000000000000000	0xb583afde568f1228694bd6ff537002c361acebaa	2393.4	13014132.958758409089497283	3913152	9	0x6c432c32f2835392670da77d46d66d882af74026fe68eb928025d9ee8095232b
60	0x0000000000000000000000000000000000000000	0xc5f444774a79a772a7f4f20fffe8c2dcb4115ee1	2872.08	13017005.038758409089497283	3913152	10	0xcabb1565b1a1b79d82277bf9ce39a21950c352e06daee57ad0b94090f13e619d
61	0x0000000000000000000000000000000000000000	0x7f42c58eec6f53638a81caa5bd989fc3b284888f	2733.190232112	13019738.228990521089497283	3913152	12	0x0d1fe5c64624a173edf9ffe904243cb9da433341842d44929a309040d2fb751f
62	0x0000000000000000000000000000000000000000	0x763d780520fcb17af0f2bd80a9eb3c76de79cd1c	861.624	13020599.852990521089497283	3913152	13	0x1fce1fe76ad0197e8f2de70bf39346757940547d2b27830aab0fe8c820080f0f
63	0x0000000000000000000000000000000000000000	0xa4998fa51d035389abc367b702855121db5051a6	1811.42020690992	13022411.273197431009497283	3913152	14	0x2a6ef9dde71576689f6978c35a114be36cce33af0f51bd5549a47c248a2872f7
64	0x0000000000000000000000000000000000000000	0xf33b41bcc4dbd712613b0f91787d02764309c456	478.68	13022889.953197431009497283	3913152	15	0x53fb6ca1a7c125801833c66de1e4daf36d833e097458fe483c6c46037413c88f
65	0x0000000000000000000000000000000000000000	0xef67a6208097869ce4dc69667d6f391a7620c801	7180.2	13030070.153197431009497283	3913152	16	0x583c4bb4a1cd4de4593d06dea9c8dc5a90361dafe2e8edd74952dce4f9ccb5cb
66	0x0000000000000000000000000000000000000000	0x52022b478aeb37e7f759ba7e8cbda22836265ce7	2393.4	13032463.553197431009497283	3913152	17	0x5cc3a7f72f5662ce756bf04c9427b6db913be4d389aa64604717931dbd365146
67	0x0000000000000000000000000000000000000000	0x99fd462735f6b8dee602fbaaa854b30b0fb6b4e7	2393.4	13034856.953197431009497283	3913152	18	0xc5b47bceb26e92715a828ea903d4e2213ca28dd73fec3d3713bc741581bfb1bd
68	0x0000000000000000000000000000000000000000	0xb359ad4af411edea51d8bd7e484b3fa007ed5469	19865.22	13054722.173197431009497283	3913152	19	0xd2273e2ad4be9b1cfb41eb9b6ec8e11723d64cae6952671f3c1fae6d72933246
69	0x0000000000000000000000000000000000000000	0xf8f1510afdaecb28f0b8a8f2f5476dc42d9db101	8523.143515596969987032	13063245.316713027979484315	3913152	20	0xdd6d6e30e3507e6ed1304e62a293bff59057fa022bd5fef6e75044465597709e
70	0x0000000000000000000000000000000000000000	0x7f4823876318fad7321fd813b7abd4a7c60c12a5	5744.16	13068989.476713027979484315	3913152	21	0xe5731aa36b0918432baf16c46ff8991cfadfcac184f051f203624e020cef27a1
71	0x0000000000000000000000000000000000000000	0x2a51187822e5a148d9779b3be007b09b7fc7a83e	1723.248	13070712.724713027979484315	3913152	22	0xd118a472060cea72a99228361ad6dcb331333e11b28ce80e2d1e3d20c64dbb0c
72	0x0000000000000000000000000000000000000000	0x8800411258c354cd74134369229b5fa2d33a6d08	1827.60024	13072540.324953027979484315	3913152	25	0xe6abf73ba49b94a9d4dbc51390ea780a3068c67e89a32d7365d86a1f7e03094b
73	0x0000000000000000000000000000000000000000	0xe7e9071aa0e36931b8da3f953dc20a81ed68111e	1196.7	13073737.024953027979484315	3913152	26	0xede6a2db6932955cdc36b22471595bc7b23c9a8a440540b6b2627315ab3df36b
74	0x0000000000000000000000000000000000000000	0xd12ff24a58fba88bbfaec7f077dd7e4d453a7e51	71.802	13073808.826953027979484315	3913152	28	0x56c4ecc86bd8e25e7c6b9b89c902a69e1f9bb3b9851cbb86e9ce36eca0b3d8b1
75	0x0000000000000000000000000000000000000000	0xe02c74aa415aa6742798d7fc656a21b88aa4fa47	694.086	13074502.912953027979484315	3913152	30	0x5f36c5acbd6b61363cbeaeb0b8654fac8833ece8123b35c2d44620515c07e261
76	0x0000000000000000000000000000000000000000	0xa82278da4f4856e5661dca8be2415e456021596d	4786.8	13079289.712953027979484315	3913152	31	0xd46315647cee93863b5949f14b6d4a2677356ff88b90366cce00f52649d5fd09
77	0x0000000000000000000000000000000000000000	0xde5865c161f2b6df00a579557235e56726026610	239.34	13079529.052953027979484315	3913152	33	0x43ede4e6039b6b6c21bf45c8ded1d6b7ef68019bdedfe934a0c77fb0339ca79f
78	0x0000000000000000000000000000000000000000	0x2a798547eecdaaf73735becbb3a892f005957af0	2393.4	13081922.452953027979484315	3913152	41	0x4f67a7df362cf16938601599469ea93405b7ee38b5583985ec496d7b9791b232
79	0x0000000000000000000000000000000000000000	0x5ee22c3f5c709c30fece68b3cbc65757d34d6402	4308.12	13086230.572953027979484315	3913152	42	0x0bfc35e1cc2dbd084f04b3af7c42060c2b81be6fe6f42cf67638b05e45176646
80	0x0000000000000000000000000000000000000000	0xd1b01eb50eac81e2a0fcf89aae5b3672776596ed	866.4108	13087096.983753027979484315	3913152	44	0x17469e7e47bebda59839d58215bb278d2c4025a81a1bca0b864220c162c079b6
81	0x0000000000000000000000000000000000000000	0x4c64d2dc1b20af77aab340606625c6bea804c360	472.8879815736	13087569.871734601579484315	3913152	46	0x4b2e67cf80c55e4aacd1525c78febdd291a305e0a6c3cd7007015381a49f8de1
82	0x0000000000000000000000000000000000000000	0xa7c89d24da721db34ec7c544688f58ea3bb6591b	957.36	13088527.231734601579484315	3913152	47	0x5324df9412310c640a0164fbeb658229061e627094415c55cd9cfa401c0e15c4
83	0x0000000000000000000000000000000000000000	0x56550afda6452c11a257d78a6942dac5096e13aa	4786.8	13093314.031734601579484315	3913153	1	0xac8233e64c6bf8033e8c698e8e004eafec7cf1e9d0f46221283345a1c4fb5699
84	0x0000000000000000000000000000000000000000	0x90ef7500c348a43d71b447d56f91f2a7bee27ce8	19147.2	13112461.231734601579484315	3913153	2	0xd082001171be65f1bf423b1477cbcc13d2e30f87eda4217b33e1b496b6373499
85	0x0000000000000000000000000000000000000000	0x61f79a083413fe2d977a90a2078ff1a9ca7770e6	2393.4	13114854.631734601579484315	3913153	5	0x741876a5a738e84f327abdcba7200b3ea456a717d7692d1eb559d5e69fcfce81
86	0x0000000000000000000000000000000000000000	0x2e206555d9073985a030074493977b71ba8986e5	383.143717263	13115237.775451864579484315	3913153	10	0x7a59edfa9d476e4c8f98be329fa7269e66bcb3a8b109d10ff1978b3b6507193a
87	0x0000000000000000000000000000000000000000	0x8179117d9ac65eca27be4e73e04cfec5440329f7	143.604	13115381.379451864579484315	3913153	11	0x8e6b93a80eb2edce1069ae7264a1db1de7aeaf35f652249499b1b4366ebfd2ea
88	0x0000000000000000000000000000000000000000	0xe2f624218c5714bc51462c0415b0a4d66db36268	1340.304	13116721.683451864579484315	3913153	12	0xa7cad1a25e1991a4ae790aa5a6197d38a8a710c26703b23438d11cfda4d60c94
89	0x0000000000000000000000000000000000000000	0xc9c78bd87922d1dc1a653f2a6724662d08265390	478.68	13117200.363451864579484315	3913153	13	0xaca7dd92a9a9109faa6d9e4980fcf8bd23d21de135f4fc1e20d3a0aee0c55e77
90	0x0000000000000000000000000000000000000000	0x661218f97ee63af34baa42d8de03ca57c2d64f1c	9573.6	13126773.963451864579484315	3913153	14	0xaf9ae969549b1eb99fe8ab7e5d0b52f26c2630352e5bcf253b74af4b7cac1dc2
91	0x0000000000000000000000000000000000000000	0xcf9777a710e7d7f0bc9b695cfa6187d6e22521e2	119.67	13126893.633451864579484315	3913153	15	0xb684c20c5f997e57f19c47d6b7efad657539c358ca653cf4332be70cdbbdf142
92	0x0000000000000000000000000000000000000000	0x840ab4f5aa381abea2e17c8bb632fa87c2ab224c	966.9336	13127860.567051864579484315	3913153	17	0xc60550c0df8aae2cfa719f8f32bd68c219a621e5784b6a2589472f979516b941
93	0x0000000000000000000000000000000000000000	0x9f7f33c6266ef3f649342187bc5a0133ff0ba5fd	7180.2	13135040.767051864579484315	3913153	18	0xcb0791d5cce9d229d94610ed103ea35c6c4ef509efabe116988497507171f1d6
94	0x0000000000000000000000000000000000000000	0xc9172bd44542212c8e49372c0292a0c932a52739	1436.04	13136476.807051864579484315	3913153	19	0xcb8bb6af19efd7daa98e6f265f642d3951cdb49325208bb6248a495f06ec1480
95	0x0000000000000000000000000000000000000000	0xc8f9a7246af6650f96401dbbee0c30e5f913cf54	3829.44	13140306.247051864579484315	3913153	21	0xec432e06d6816d4d8e0391510e85be06cd7473920c91aa8f51413c964e1c2e9d
96	0x0000000000000000000000000000000000000000	0xabb8cdd71ffca5d9607f8cc56c1aa8b1ed135f37	1723.248	13142029.495051864579484315	3913153	31	0xf30d0c4cf0a05f8f6eace6d94187a92c193b9e329309f7d5414956325548edc9
97	0x0000000000000000000000000000000000000000	0x78720b400a04f502e1438722d6addc76b97d69a9	1909.9332	13143939.428251864579484315	3913154	0	0xff06ea8e8a9160e7fb01228e804e703eb8c4ceb0803223dc6114e9e9b837c09d
98	0x0000000000000000000000000000000000000000	0xa63ed2b096212c8032750befaf8eb08709f1251b	22497.96	13166437.388251864579484315	3913154	1	0xba6ac232f29c9e82f5ac89d7e70685850ef8c8f5a82805d87765b97d80f4f704
99	0x0000000000000000000000000000000000000000	0x5e1d61e07e982aedd99cfe1fd72cbd82f0bc2d35	95.736	13166533.124251864579484315	3913154	2	0x6fb122d57f3e1781eb84b20c778870b1c0c2e14e67afff70ed186ab6d1ab1697
100	0x0000000000000000000000000000000000000000	0x00cdcf1fa2d2cc421925c83fdbce88e414559b8d	1292.436	13167825.560251864579484315	3913154	3	0x33adf240241810f94802567c64e0a0c0cfee48e03655ff4fbac8bdf2e17ffd9a
101	0x0000000000000000000000000000000000000000	0x49a408f1ee8951c509db64be3cd47a0faf81d2a6	478680	13646505.560251864579484315	3913154	4	0xb272a66c0c163ed33212185641e48276140b5e68d66c940b85d08356885c056f
102	0x0000000000000000000000000000000000000000	0x4681b4a6e40bca139f008fb3fcdfa7bfa4bb5b57	478.68	13646984.240251864579484315	3913154	24	0x12250834272be2ec0663e338d523b0753520b20b219259c879b7c2641a17299a
103	0x0000000000000000000000000000000000000000	0x93d79977ef117007a0028218d99dd2caebd70b55	23934	13670918.240251864579484315	3913154	25	0x1852601635fd392563c9991a9bb7921deec1a729088cdc28922e724763341a5c
104	0x0000000000000000000000000000000000000000	0xe997070aba8a8e579b6c4dfb6aca219b06f0bebd	718.02	13671636.260251864579484315	3913154	26	0xd8e1df18f188fc4b2a593df062e21fe53fb1a941d18ff3a5feda58d717578eca
105	0x0000000000000000000000000000000000000000	0x5daa1388ab4f4bc474f4d569acb6ddf0b2d38505	48.1506413928	13671684.410893257379484315	3913154	27	0x531930e6617f90e71de3a905be4d37eb0a6d9ded2ea7e71930ce0607dbb167a5
106	0x0000000000000000000000000000000000000000	0xb40c6e480893e4e75b73bbb812befeda9d09d3eb	4784.4066	13676468.817493257379484315	3913154	28	0xcb9db450a8fc9f2dc9d00116a377921a84e685072c3b46e898fd421aa6aca80b
107	0x0000000000000000000000000000000000000000	0x62895b65f36bddf1373b363dbd7f7696e0fd2ced	28720.8	13705189.617493257379484315	3913154	29	0x5743317236aee0f201d55807f8abbb960dd3a653344a77a833a6ea12fd46fdc9
108	0x0000000000000000000000000000000000000000	0xa2f632faaa7ef48e70bbcfa33595557d5d960f5c	3494.364	13708683.981493257379484315	3913154	30	0x13afffe5246f52b70c4d335d881eb1264f036eea29f5b38b2a9db8d7ffb0698c
109	0x0000000000000000000000000000000000000000	0xf6131acf10adb4c1d42a5aa380503081fa6a4fe9	95.736	13708779.717493257379484315	3913154	31	0xa54de0c01bdf83e6fc40474d18a54f104a41fa5e02edfd6cdf2138f3d3363ff5
110	0x0000000000000000000000000000000000000000	0xb950a3638d2ba14b2fa64bc8999f0f4b59850216	5744.4256674	13714524.143160657379484315	3913155	3	0x9a1c7959fe89f9c7219fc74d8ea90e926be787e755f763de421f6bc41cb1a933
111	0x0000000000000000000000000000000000000000	0xfccbe6f6f2e42bbcd5d6fecc1ad2184a90cb734e	382.944	13714907.087160657379484315	3913155	5	0xa0abcf4f1f8c5756097bbe4b97cde6d7d811ba18b25266219841012722631ad9
112	0x0000000000000000000000000000000000000000	0x3a2be3642a8c64b4b2884857dcfd7668c411ff40	1005.228	13715912.315160657379484315	3913155	6	0xa976685f2e2c48bdd19d05eaa94687de427839f3dedc7e816cb07b64c23695b3
113	0x0000000000000000000000000000000000000000	0xc1cc1cf75e85b92b466816fc240ff1450675e299	4547.46	13720459.775160657379484315	3913155	7	0x7c2f9cf94e44525d8824f002a36d616119c0fcf70d49b75c81fe4bdfc686cbdf
114	0x0000000000000000000000000000000000000000	0xb968569c26dc5da1984e3f0ad3943088b05f8194	1914.72	13722374.495160657379484315	3913155	12	0x1a8dae56725f85c765aaa55b9b8e5a61dc670e1bfc8f5bf09d9566620ff1a3eb
115	0x0000000000000000000000000000000000000000	0x2711e14cc2155b143781ae2fb49a0c25e30932de	3517.81932	13725892.314480657379484315	3913155	13	0x2924d8b05fb3c018e2f47a509fd6ed3d0d043b77d443556c1b2fa7e60c0a66a3
116	0x0000000000000000000000000000000000000000	0x3338085efffa884efc10d7f265d512e1dc34191e	478.68	13726370.994480657379484315	3913155	15	0x4410437373d02cd65c98ddc06597693d06ce711c6bc02fa472d9961f7cbacc6d
117	0x0000000000000000000000000000000000000000	0x0342d1a7e22baa5410ee8c72873e7a67c7b20c77	335076	14061446.994480657379484315	3913155	16	0x57803d31a7c9ad2b01182f76a394ae23bac28ae86363f74db31b7a095f9d7095
118	0x0000000000000000000000000000000000000000	0x97e73f09465656f8d60b41d555be4edd823b3c00	1914.72	14063361.714480657379484315	3913155	17	0x6c9fadd08752732cbd22651a738121575a8ebb5c3083095e4a3b9a1ab0abe696
119	0x0000000000000000000000000000000000000000	0x66e6f64cce4e6e2f483c5743a365db3087aa39e5	478.68	14063840.394480657379484315	3913155	18	0x74c5cf659ede233baaaa26805f9864a82d9f9e4a05e06e03c492b088d086d36f
120	0x0000000000000000000000000000000000000000	0x0c286300850e2e15c1849e0030d30cd3f9410053	11967	14075807.394480657379484315	3913155	19	0x8d2b9e3c6964d35a407ad60477d6dd3017384ecbf9d478b850e7eb3c81a162d8
121	0x0000000000000000000000000000000000000000	0xde3f13b04a9479a7a105f750d3732d6d6568503f	2393.4	14078200.794480657379484315	3913155	20	0x97c7764ee5de7e248d419b1c16bcccebfa09fd2ca026c4933e4154af45a6e7be
122	0x0000000000000000000000000000000000000000	0x59bc0ab3d489198f9aa56495fe6890aaf8f6bc8d	1196.7	14079397.494480657379484315	3913155	21	0xa7f13b5815131551e3bb93f1e117ba3a8f2fc0f64fbd864b20a59915ccdfb6b0
123	0x0000000000000000000000000000000000000000	0xae5e4a0aba8fbdd5e9a44a1f7c339b124a167bea	47.868	14079445.362480657379484315	3913155	23	0xb1a0c2656989c0243c2c2ca412ecdfc67f8b584117e95392e0b8883740d7027d
124	0x0000000000000000000000000000000000000000	0x0eacc4ab348e8456051f094058dbbdb1653a4da5	478.68	14079924.042480657379484315	3913155	24	0xca9489b84f284569b96bb15e1c24908f6fee1a02a88b414a3a165e23085f319f
125	0x0000000000000000000000000000000000000000	0xf190f0193b694d9d2bb865a66f0c17cbd8280c71	9573.6	14089497.642480657379484315	3913155	26	0xd80312015b1f7b9ab8d13b052993b8e62c03337b269c6b43c72a51920d7a39f2
126	0x0000000000000000000000000000000000000000	0x6c2d1d29c23264b41d0c531f4cfe3fc1dc0aed51	516.665838510465521436	14090014.308319167845005751	3913155	27	0xd98c419b43fea5481550b3289f53fa8b94feff570176d4f2f78555f62cb9dfd6
127	0x0000000000000000000000000000000000000000	0x5de9fe14fdd59736771102f3e9539a3b1e45c37c	6510.048	14096524.356319167845005751	3913155	29	0xfb11f55887373c57af06df88d56f2b172748fc05f46d6374ae9152dcb639b98b
128	0x0000000000000000000000000000000000000000	0x9b388ce5e6089f53de298e2fdfe830bf43b06a17	1436.04	14097960.396319167845005751	3913155	30	0xfb36d153ccdc42b6662f84bf46bbc571885a11e7ce92fe5b25838aec5fea280c
129	0x0000000000000000000000000000000000000000	0xa8638085d18c050e0d7780e557a21b5e028f4d70	14360.4	14112320.796319167845005751	3913155	31	0xfb7539fc12fae0fe107b88503b532969dcb17a7dfce3913fc6e7345630f487d4
130	0x0000000000000000000000000000000000000000	0x02203df183032281411ffd6f9f80bf1f53bd9fe0	957.36	14113278.156319167845005751	3913155	32	0xd93208997d92af880375dc602b8cdb163f58a6c6c1a1707d9f490a0b92cd9ce4
131	0x0000000000000000000000000000000000000000	0xf0f5ee507b1c8c8ac863d47a7bd5a678fd213cc8	944.22247135032	14114222.378790518165005751	3913155	36	0x1e1f5a0943ffda7abbdac0d762b33f5245c83f9b60d21446b68c064bf8964646
132	0x0000000000000000000000000000000000000000	0x6ed98129ca2887b8c277369df7e02b945dd6627b	2393.4	14116615.778790518165005751	3913155	40	0xd644b530174edf751662451135a63428e16b667a4eb2832a220719f112112d75
133	0x0000000000000000000000000000000000000000	0x08300312b641cc7b62c2867caeffd0ae390f63e7	478.68	14117094.458790518165005751	3913155	41	0x8efd469a770bc1c2e9cbb387b9993ca54af851148be34489b5725dbf3535c2bf
134	0x0000000000000000000000000000000000000000	0x53e48e09c42b717906e8f0e7cf562af347877787	9573.6	14126668.058790518165005751	3913155	43	0xbd5a18c8ca7c1941bf9d9261d4a07b32f6260b44484bb0d365b971d0aed0520d
135	0x0000000000000000000000000000000000000000	0xcf368b71b1f5e4580de52d617ac861fc2ca590e6	11493.1068	14138161.165590518165005751	3913155	44	0xd30f5def454c8ec32e01e5f264dac582b920448c29cc4da54a81cfe11063ec33
136	0x0000000000000000000000000000000000000000	0x43c0af7b1a0f77f0c448132ab04d5dc8f1f2cd89	478.68	14138639.845590518165005751	3913155	45	0xeb27d27000499aa58dec48f1745e42454d7353e60f7a11d2a10bf5012e86efb4
137	0x0000000000000000000000000000000000000000	0x641bcd2660d35798aa68bb37f7b33a07610602ae	4786.8	14143426.645590518165005751	3913155	46	0xa3b71cbb924a499f29b0b9e9475a2de3489e2d6e352ea197207d2ac95c7c432e
138	0x0000000000000000000000000000000000000000	0x34f233b1498cbf5a9f54e9aaf6daf4436cacc49b	478.68	14143905.325590518165005751	3913155	55	0x668c9e4d830786a88a0bc0ffbb6b0472280458d0238931155d34cefe1054df1c
139	0x0000000000000000000000000000000000000000	0x2029d2126b7f9cd90a6b7e3e5546f4a2fba4e92f	1914.72	14145820.045590518165005751	3913155	60	0x01d185994f8d1c49fc05e3c784a9635383d47ac9ecb0d7d770f9172a55637fdc
140	0x0000000000000000000000000000000000000000	0x77f1c0375e0a76d4303a4cdb628842ac7fb72387	3829.44	14149649.485590518165005751	3913155	63	0x3c758b485fdf0d78d939ae55b165e04d090154d40739bf830bd00d51a2df8496
141	0x0000000000000000000000000000000000000000	0x82dfec4e97b76c474533b3dbdeb1a87965b9bfb9	47.868	14149697.353590518165005751	3913155	68	0x73df32ad49f6f345e9ef9312f5b150545f1972ad3aeb5061f6e602b4a3388e2f
142	0x0000000000000000000000000000000000000000	0x6f95d2ef761c45d499415d7890276dd9f28d396c	1517.4156	14151214.769190518165005751	3913156	24	0x076b061166e29922860917c5718b39be3b7684b1a1e3b6c17a7620c48f9a7913
143	0x0000000000000000000000000000000000000000	0xdb280e6d13012e5285b22fc00955b316a5cf525d	35901	14187115.769190518165005751	3913156	25	0x1bf36cca2bf382364b50e62aae1d88a3dd7f6dd2456426d2c25de63f5ab7afaa
144	0x0000000000000000000000000000000000000000	0x78c875d7dff83ef985c94bfbdb3e43dedbf0ae11	574.416	14187690.185190518165005751	3913156	31	0x74144be183275176da3759345f19b2fdfe0f589179a2acc744df956ca280d037
145	0x0000000000000000000000000000000000000000	0x659295be0e039b35c73ceb9dbd9bcd7524c09cf4	1914.72	14189604.905190518165005751	3913156	32	0x87012312dedc57313345029318620af9cdb415c40b6dbd0d016b038f9e4b7867
146	0x0000000000000000000000000000000000000000	0x5050db4c124c63d6d9aaf7aaaad6432023502fc9	2872.08	14192476.985190518165005751	3913156	38	0x30dc21323d14ba650f2b6ee1074e1ac5a793b89dea7e6d1c9f158a619c0586fb
147	0x0000000000000000000000000000000000000000	0xd5347709ea55f4cc154050a8d8ba5a8cece6606e	2393.4	14194870.385190518165005751	3913156	40	0x98f7adaea35ae4e8b1aefe7b482cba390e70a0fc891996eb3895fee8fc33cc66
148	0x0000000000000000000000000000000000000000	0x608a8f13b19b7b6c5e504f590256c524f15dbbff	622.284	14195492.669190518165005751	3913156	41	0xfeae4c8f5be357f574d2a2909f467190578c8175fe99ed9112dd3ad993b81e41
149	0x0000000000000000000000000000000000000000	0xff9a5445bfdb6e0d97458ec18d48ba59c034643b	1436.04	14196928.709190518165005751	3913156	42	0xc6ed26236f779b8995b365a3dc986d095852a9cac4aeaaa97db59f84f8e7d0c5
150	0x0000000000000000000000000000000000000000	0xf144900e89b8d962253295c1e2590651fdd32b14	4786.8	14201715.509190518165005751	3913156	43	0x629405ecbec48aa85d38807abe60bfc48d996bd7e33c5aa155ffd1ff4e5f0701
151	0x0000000000000000000000000000000000000000	0x4ccf37771bbb305d8838806fe311c1c34da744a3	239.34	14201954.849190518165005751	3913156	45	0xb351c2e325e1602348297d96f77c0a70655340e0e193625b1a98b3a18b8ad672
152	0x0000000000000000000000000000000000000000	0x908242745ca2083ed617f3edbf97609f5c5ac98d	957.36	14202912.209190518165005751	3913156	49	0xd2401fbe148fbe1e886c01f991dfe797c86c1e451f9760316b3a2378d5273c3b
153	0x0000000000000000000000000000000000000000	0x36525cb405fce129a2259c4d332a5e8ca6df998e	239.34	14203151.549190518165005751	3913156	59	0xbfacb6086920676012c62182b2555f485d21db6160c1e63457284eac5798bc10
154	0x0000000000000000000000000000000000000000	0x03b963429b6bff571a723672e4e5318e6f84403b	957.36	14204108.909190518165005751	3913156	60	0xc4c220afa2248bb6e4214767d0e9d0ff27ac767dc862c87e4a50b6600e026ff3
155	0x0000000000000000000000000000000000000000	0x8aae50113d811edf6653ee28a779cdbd2a783707	9990.0516	14214098.960790518165005751	3913156	78	0x0239aae4022bc2c3fbff7c3134aea5d96b45e441f8f475809c1c1b3f99d3ec6c
156	0x0000000000000000000000000000000000000000	0x00af36c43ab459a4eacf93467c400ac45bcbc124	1436.04	14215535.000790518165005751	3913156	81	0x0dde13272f38977fa5a1e16d459ecea7a1c521784fdcd4ed2daec921865e5b51
157	0x0000000000000000000000000000000000000000	0x4d341e05917aff53b62d942f2c1b09c15034290f	1005.228	14216540.228790518165005751	3913156	85	0x27e57ed828fac0cca522ae09e3616ed8d4269e91db68be07997489fcc3a08043
158	0x0000000000000000000000000000000000000000	0xaa0bc32c25161ae2d1f0163525429fc3f6cbcb6b	957.36	14217497.588790518165005751	3913156	86	0x35f1e7b442eccee170925f7ecd46ca7857744aee1fedc6d6aaba12c28f138fe7
159	0x0000000000000000000000000000000000000000	0xbc88f3d162fdf6046fc6069a856bd373e5f34396	957.36	14218454.948790518165005751	3913156	89	0x48aa49c7fe2c1ff131f14509bf1ec842195d40a01a937b062cda3860bad3df16
160	0x0000000000000000000000000000000000000000	0x76b1ad9e0a10ab271feeae910fe8e86350ba4b72	574.416	14219029.364790518165005751	3913158	2	0x8f1655cbcd7e9cae6dd1dde39f4fc4d49a5e5dc481d17a47e43766ecdf7eb5d8
161	0x0000000000000000000000000000000000000000	0x8e3f876c66ab6b3274f97181e049ba2e3fe74f2c	4786.8	14223816.164790518165005751	3913158	4	0xa42bfca52f4c78890a668a3848160cdb38bacbef6ea13ff750372f89a1eff64d
162	0x0000000000000000000000000000000000000000	0x74303b81beda2874e4a918a5ea0f292ae89794cc	15509.232	14239325.396790518165005751	3913158	9	0x7bd0ccc3906327ccdf28ddebb501acf4474de8a2d10bb81828c5e7e148bfdfe9
163	0x0000000000000000000000000000000000000000	0xc1e942af37b4ef0fe04dfb0e9e6bd0269d48ef24	1005.228	14240330.624790518165005751	3913158	10	0x2b83f657ce6c6782a7500b50476e8e6f85b8741e7d23324855f8fe78295d8d6b
164	0x0000000000000000000000000000000000000000	0x2be8055d8a3fc3191f39f21d6a3979aaf9ee8075	4786.8	14245117.424790518165005751	3913158	11	0x50153d1e7f0086207cd4d0dee56deb63301bb24b85d1350c581127cccde7e3d9
165	0x0000000000000000000000000000000000000000	0x0da6fe1e9e1521bacd1c458932e778ed2b08d1e2	19147.2	14264264.624790518165005751	3913158	12	0x480ededb83ea2d65a5bbddf19e48ce741584744a5126fe2fd98356098175e0e4
166	0x0000000000000000000000000000000000000000	0x5e91a5f226299856d227c552827aad9859227be2	957.36	14265221.984790518165005751	3913158	15	0x516cafdf9989f2c3f1f2d75b66d2c584ee96f3960bc934dff051d15633ae9f8e
167	0x0000000000000000000000000000000000000000	0xec30eacdb39705ec281e10891d605cb0be41e094	239.34	14265461.324790518165005751	3913158	17	0x3ee44a37950a73dc0a7be930ffcd920b5208436eaa0d7d87a1a877b9df2c0f41
168	0x0000000000000000000000000000000000000000	0x6e2f397e4a349b50d2c2a74053cdd6730edc62b2	71.802	14265533.126790518165005751	3913158	18	0x62e980cff2150c3429a496a4ebca37254f44e91a2fb7a5da8f183193b333e5ef
169	0x0000000000000000000000000000000000000000	0x882ee04d37f6802b6bad9448e7136bc7ebe03187	488.2536	14266021.380390518165005751	3913158	19	0x6a5a0a26ccfda4d432dfee543d3ace3d449859dc71ebf4f67f244e1e448e0e9d
170	0x0000000000000000000000000000000000000000	0xf85108a0b644dffb480fc9d84dfb365ef6a4b3e7	469.082466	14266490.462856518165005751	3913158	20	0x79280998a173a8974592b3174a51cc9930582ae21fe8899fcbbd591702798ecc
171	0x0000000000000000000000000000000000000000	0x0a3f25c0dcc58dc53e9ce36214f54feb6503a879	47868	14314358.462856518165005751	3913158	21	0xaae4ae960cb2c4c561805adc8abec249c95a13abdfbbca86f846eb91d518bb04
172	0x0000000000000000000000000000000000000000	0x67a8faf6fad5f75f9097f1f31b7a7ba66637d2e7	33507.6	14347866.062856518165005751	3913158	22	0xba8d001637fa570c817fc5ac4e4e51e7ae498e21b5b72536171a08b62178d829
173	0x0000000000000000000000000000000000000000	0x2f05617291ab3bdb23c5dbd62ab68b66ab04ebe7	28.7208	14347894.783656518165005751	3913158	23	0xdfd7fcc5bfc420fcba5e01fb7d37261f9510248072cdc4ec94680b50eb2b5240
174	0x0000000000000000000000000000000000000000	0x62895b65f36bddf1373b363dbd7f7696e0fd2ced	1436.04	14349330.823656518165005751	3913158	24	0xf65d42f4c51f5360ba3c8327ed023c5dd13252d5dbfcb9c19fbeb63a8adc5b6d
175	0x0000000000000000000000000000000000000000	0x1285195ca5bb316d316ea8afb927c7c6818ce189	1005.228	14350336.051656518165005751	3913158	25	0xfe26b34eafe9e3486715761297ecc8e3f2510b8037e60eb7e03174d6e5141be9
176	0x0000000000000000000000000000000000000000	0x7c9c7e01e0c0fb8e4d364ef5cf6e47846ea6fd47	534.015408	14350870.067064518165005751	3913158	28	0x2590bb44a4f9c8c921862a91799573347425d1168aee9a23d456cd635dd5acfa
177	0x0000000000000000000000000000000000000000	0x9f97b80e09da70abbcbe9b16b7bb0102abd91eee	9573.6	14360443.667064518165005751	3913158	30	0x86c4e9c0eb337052b7fcc5625ac318cf2a48865796fcda58acd5c57b88ab7e0d
178	0x0000000000000000000000000000000000000000	0x4e532cd2bbd887ac97fd1278ea2efe9f324af12f	947.7864	14361391.453464518165005751	3913158	31	0x484c9bffb80626fc4737bbd12f52e2f387cd188aa9a0727e3bc6d779a48e9ae6
179	0x0000000000000000000000000000000000000000	0x85f89a3625c076e67d95af92f3d048e8cbe7d5be	12206.34	14373597.793464518165005751	3913158	33	0x9a8ac25da3cd9b709c7b84de47678fdc41a098e3e449231d7ee82f9d7f47b93d
180	0x0000000000000000000000000000000000000000	0xeafd621cdb0d6e576ba86c321c30407eb7d7fdbb	1436.04	14375033.833464518165005751	3913158	34	0xc2eab5178db8beb34b66848fe60ca66c63cf62cdc619906edfb447af96f7c160
181	0x0000000000000000000000000000000000000000	0x359344573f2773dc68732552605606f40f192edd	3053.9784	14378087.811864518165005751	3913158	38	0xfe1a35e19650d2cc12694721f37425d52255190138176e4eec3ba1c44f903d77
182	0x0000000000000000000000000000000000000000	0x1d9643358cc78a3a8a08b084e2e8262bd4848ced	23.934	14378111.745864518165005751	3913158	40	0x391031bf606eacb8c2912de84d7d2a36beeb6a5e89c00f188bd6c21654522f45
183	0x0000000000000000000000000000000000000000	0x45c556aff90d5fe6e91d24874a8036693cec18d0	33.5076	14378145.253464518165005751	3913158	41	0xfe3e3d40a17268b759b8f77dbfd95513e8f1f7aff9ca751055022a6393b2e707
184	0x0000000000000000000000000000000000000000	0xad3142f31ff778427d2b12ea5ed4312b5294597e	946.149422103	14379091.402886621165005751	3913158	57	0x1fd8ca72c24231fba7da26b5b82499fb0a5998ebe4e6506b08a9536d4e7179e3
185	0x0000000000000000000000000000000000000000	0x4b90e5820fd896b286c857788e931117c8ffcbf9	454.746	14379546.148886621165005751	3913158	58	0x286775b6a276e4cd4c9510ea699bddbfd3804e389a0e3f7fbe6fd7c98c7deb31
186	0x0000000000000000000000000000000000000000	0xb300ea13e72ba6400b8fee073482a70090a5a8e5	2.3934	14379548.542286621165005751	3913158	59	0x28ba8575f6c08d7080281e14002ed48b6b6bdb72ef5d32f3b2ce94a386047b55
187	0x0000000000000000000000000000000000000000	0x5ba3d9a9c6390e0df8e13e9cb95ae236f8edafec	478.68	14380027.222286621165005751	3913158	64	0x540f89a53b84f09fc6afd33cd61b42ebc2ee81589a4320ecaf2205b81a683095
188	0x0000000000000000000000000000000000000000	0x3fd6c317dcf9831630b520262045a244502e8bc4	95.736	14380122.958286621165005751	3913158	65	0x5cb23307f771609e2c8c4171f64512cf915fe10b3bf2fd246818b68acbcd484e
189	0x0000000000000000000000000000000000000000	0x0d65f0efdea623c9572e5b41045cd367c3d6883f	8.653971951	14380131.612258572165005751	3913158	66	0x655df65537e81a9c1a6911d03833faba965eea80753744d21fba9b352adf9ed6
190	0x0000000000000000000000000000000000000000	0xce6e6b361c7a6947bccefcf6cd14729e8e357035	4781.53452	14384913.146778572165005751	3913158	67	0x683b2fd0d68b375ce4c4da0a5bd7b3cfb702fc6ffb2890afa4d927ce9d5527a4
191	0x0000000000000000000000000000000000000000	0xd09bc98c17c95b6786436feabf16642c5b882eb3	9573.6	14394486.746778572165005751	3913158	68	0x6f3e89978e3b72bfdfbcb24ab4642b8dbd2ad19823889800eeb1e01f668268ce
192	0x0000000000000000000000000000000000000000	0x5e26a41dd12bcdf4d48db7ac12ef26e8772781ec	1053.096	14395539.842778572165005751	3913158	69	0x796a14dfa00d7aaa45595c5cfe6719061919882e9aecd95c2ebe1a186c6094a2
193	0x0000000000000000000000000000000000000000	0x94aeca1c849e99b373a7ba800c02c3036c5e4976	1439.86944	14396979.712218572165005751	3913158	70	0x7cd60e3e7153a660695513a0ec3df114ed4c07e2b27b18adefcf04998f53f1d9
194	0x0000000000000000000000000000000000000000	0x8c78f1ee67ed97af4f26561dc57e3757e734d0eb	765.888	14397745.600218572165005751	3913158	71	0x7e7825023742c9986442abd229a4ca26e4949307704f5e5afbfe809ab99c1d64
195	0x0000000000000000000000000000000000000000	0x05d272c6e2c6c6dbce857993012cba25689a8850	1436.04	14399181.640218572165005751	3913158	72	0x865c45838dd0aa41724ef6931df5841e8519d4edbf42d877ce453ed68dcb424c
196	0x0000000000000000000000000000000000000000	0x5f84a188938dce9b60fb6811ad87a25ebf651422	4762.866	14403944.506218572165005751	3913158	73	0x8b4960bf7dc73c18cfed2835dbfadfd344d34b34b6390ed7fbcb7347a4021607
197	0x0000000000000000000000000000000000000000	0x1e40b8e18e7f09afcf35bf07d2f35222aff3797e	4786.8	14408731.306218572165005751	3913158	74	0x8f96d005846f65c16f853f9f368c6fd2848fcc6b5d5e720692885c9383b5efc0
198	0x0000000000000000000000000000000000000000	0x3bcd2d9c796c0d5d0e26918d78b81366fd284861	97593.786710292	14506325.092928864165005751	3913158	75	0x9623359f7558c8ea3bcf88dccdf91ed6f5f8f97828fed4a43cc2af3b1f1f5a67
199	0x0000000000000000000000000000000000000000	0xb270dd05f41a7fd0ffcb3dc26f3f982998a7cfd1	3255.024	14509580.116928864165005751	3913159	0	0x4bbb052d1fe4a8a2080005b5c7c5e84218389ccda1cdc68da5c7690f67ed252b
200	0x0000000000000000000000000000000000000000	0x176aa656a613e2be0dd620eb81146dd94b41faab	239.34	14509819.456928864165005751	3913159	2	0xdd3b69cecc7e614c7e87f757ad502b42189cd95ebfd97e1a68d8b939f149f258
201	0x0000000000000000000000000000000000000000	0xde59823196d9a85d45f0151b196e9e3c7ca5cc3f	136.4238	14509955.880728864165005751	3913159	3	0x18613c08c8264f8a284a819d3f2fbc7ef1d00e7f37b77b0d98d32ef1c9f4e8b9
202	0x0000000000000000000000000000000000000000	0x355bc9d8cc2cde13c5073276d145d0e3d210b2c0	6222.84	14516178.720728864165005751	3913159	5	0xb0ff783867bb27bc2c9b57b0520313b5c4ea64a72f6f077933126fd9caa66381
203	0x0000000000000000000000000000000000000000	0x83bad39f067ef72e354f2ea9d318eaad381a7f15	239.34	14516418.060728864165005751	3913159	6	0x38dd75b44a58d17194d1e31221c31efbbeaa9987902e9899d591a1d2349fc070
204	0x0000000000000000000000000000000000000000	0xe91064b4c8d1e9aa611cce2eed5ef8484a31f832	2393.4	14518811.460728864165005751	3913159	7	0x4dc93428ccf20bf6288711b95f94b82e38ed3ea30690b7065b748230e1ab1a07
205	0x0000000000000000000000000000000000000000	0x2b4b1b46b49c75451f2773bd1c56797b249b27e3	155.09232	14518966.553048864165005751	3913159	9	0xc23b30471537c11f87bfd46c33e78b6f6eb6be96940514cff6b4ce4736442452
206	0x0000000000000000000000000000000000000000	0xa81c19cf3404e314217332e2b6b1283570a33b9f	2393.4	14521359.953048864165005751	3913159	12	0x49982d6d0546a29a3d07209f4c308e0b0505d2a1e4b4c21c6c3e3a3a3a4f8118
207	0x0000000000000000000000000000000000000000	0x3c154d6a5f53e66085ce1d7c26f23aeb6d6b18ac	2393.4	14523753.353048864165005751	3913159	20	0x45beb047831ba5033e323008045bba01493a236d8f1b64c8232a565febfb4cff
208	0x0000000000000000000000000000000000000000	0xc9f9430c90b2566d28bc00c6a74dc5fee4d63351	6701.52	14530454.873048864165005751	3913159	24	0x1332ffcd6ee581d4930093961e49d8a1d1cd4843eea876e68959a63db4145bf3
209	0x0000000000000000000000000000000000000000	0xeae865bfb6f1eb4a972074fe3e50b7f00ca5d618	2393.4	14532848.273048864165005751	3913159	27	0x85b1bf170106259126d3b5eab09f3e67791e7bf6ff8899f54e529683591e7efa
210	0x0000000000000000000000000000000000000000	0x9df668b00d9a4f875c2e38c15c67913bebdb242e	3829.44	14536677.713048864165005751	3913159	29	0x9acef901ba0332f5cfb2c8c18a41bacf0cb8c3794bf6c55f280faf725c442d65
211	0x0000000000000000000000000000000000000000	0x9e36ac0364ed1e9401bd2d197577661532b853d9	1388.172	14538065.885048864165005751	3913159	31	0xa1d2de3e480477a637b8cf28c14435b2a7aa34d11e1a40009cabd2469581f2c4
212	0x0000000000000000000000000000000000000000	0x06245d33485ba1cadcff93f9c8b02f38bca8d4cf	14360.4	14552426.285048864165005751	3913159	32	0xa6f4cefd54303587eea78e369540add28123e5ca7de8256d03718df42a82be9f
213	0x0000000000000000000000000000000000000000	0x4fb34e3bdf2728dd4834c28c2a3f233b43809c90	4068.78	14556495.065048864165005751	3913159	34	0xb4fd2df2d623d8603698de38a01d8201a2d20e687253a28fcc3758606dd966f6
214	0x0000000000000000000000000000000000000000	0x438543846dec17a7aed3481c9c8363d2f759f063	1914.72	14558409.785048864165005751	3913159	35	0xbc693a1c9c14873447fcc744086081c1f13502e61bb97378bc332ebf65d4d6cb
215	0x0000000000000000000000000000000000000000	0x1a40746dc1fb9d6dfb4e4ba6f952e6aa26e88b3f	1335.64931568	14559745.434364544165005751	3913159	36	0xc1be8d8a6f56f5c9e68aae441000217eea06416fa4669c683045aa2d1d2bd87b
216	0x0000000000000000000000000000000000000000	0x56e564ca8f1560cf2649ba9a27203f8aaa2cfd1a	2154.06	14561899.494364544165005751	3913159	37	0xc27d04a35f980647c20cf684d3cab1f9982f5a13ba8b7fa03c430bd918110794
217	0x0000000000000000000000000000000000000000	0x0caae67061289a747d458adf715157eaa60c399f	493.0404	14562392.534764544165005751	3913159	38	0xcad6a4f8206ac15ed73d042fd098caa149a6b89560ddd11371f32efa7227fc18
218	0x0000000000000000000000000000000000000000	0x1cf16bfb364bd4b11f9f6a0706fe4c2b3aa0439a	9573.6	14571966.134764544165005751	3913159	39	0xcc3d4270c64f3ad88ff1073f9956f17e9a4ee42815a523dd1277cfe78a86a05a
219	0x0000000000000000000000000000000000000000	0x48e95534519eb31afb8606f5fba2b56440262227	2393.4	14574359.534764544165005751	3913159	40	0xd71fd95fe7fb7d0159abc131fb08fafbd6845813de20abd7140069e59ced0363
220	0x0000000000000000000000000000000000000000	0xd321d44fecac9b8f1e34276dd34fc3072f52af30	7180.2	14581539.734764544165005751	3913159	41	0xdab1cae93692b73e5a86c9dfb2efea1b04d3653f57d0f6d673fbddff3f1e6fcd
221	0x0000000000000000000000000000000000000000	0xae66bcd3305ee538406423b86a899643a3835524	560.0556	14582099.790364544165005751	3913159	42	0xdc0104f7632f3ff2144d6b504dcd47586ed72493f44b1bf43b4d7c0f9b8db595
222	0x0000000000000000000000000000000000000000	0x28e620f0bd68e8b8f3b50b1a61e54fd968e071b2	1100.48532	14583200.275684544165005751	3913159	44	0xe9e37c5763c8404a9ce757d5f34758823069a8f125a41364ea761ec2a674fdff
223	0x0000000000000000000000000000000000000000	0x17e9fccdb69afc21ec033dea707c62c79f69e425	957.36	14584157.635684544165005751	3913159	45	0xfd0f91c4fa7cfdc68a3dc18d2c1128b2c455bde0aee58246430609a4b2c22d82
224	0x0000000000000000000000000000000000000000	0x3fcc9668b3e5d4948ebd744a40fa7571a5541191	1268.502	14585426.137684544165005751	3913159	46	0x22ca1d22fe6b8ab9ac145edbeae53063ed4b080082234fe4cac6ed5af1cb2c62
225	0x0000000000000000000000000000000000000000	0xa08b860a69bdae648eb5bab8ca6be97cf9cc54f8	2417.334	14587843.471684544165005751	3913159	52	0x8f10da228d818565329a2bf628af3b16cd4774ce6e848886eb7fd00f1b2366e7
226	0x0000000000000000000000000000000000000000	0xc1ea49912ce10d0a8864ea3ca85c9b8956923303	143.604	14587987.075684544165005751	3913159	57	0x89e69bf17984e3059553601286ea6a3d8a8fe63f8cdacf6cfdb80e7701413ad7
227	0x0000000000000000000000000000000000000000	0x8d8459a13e3dc3e4146540ddbd21dbff06ea0d82	478.68	14588465.755684544165005751	3913160	0	0x3001adcb714c3afed830a7421f7d8cc6bdce5e8530e573d432a884b273cd67fd
228	0x0000000000000000000000000000000000000000	0x151797660e5802b2a3a8aa853f96608dbf850e39	5691.5052	14594157.260884544165005751	3913160	1	0x14774d00514e15d432567574e547a6f028f7b48aaee2ffea23f8854c7b7213d9
229	0x0000000000000000000000000000000000000000	0x942ffc52cfd75b5ecf517cf4ff2238107d3122be	1914.72	14596071.980884544165005751	3913160	2	0x4639516e133fe045099f20d5f8ec2c1a1af43571aea711336092e3de43bef21b
230	0x0000000000000000000000000000000000000000	0x05543b05c8be29568535de85fb0eec41b70de5ca	260.8806	14596332.861484544165005751	3913160	22	0x7af0334bc76f3a542fbc7285ed973c4beb93f8667408f4c4135b1c46dc50e503
231	0x0000000000000000000000000000000000000000	0xd1d7a755654aba85bb151f63b5da6c3289eff55f	128.810872668296380359	14596461.67235721246138611	3913160	23	0x7e85b2878e1e6691eceba99afa20808449c4032242cd36016f4fdd68d69d0446
232	0x0000000000000000000000000000000000000000	0x1e0cc3a5526d0990c3b10575af88a146bbb0a8d2	5282.569821393	14601744.24217860546138611	3913160	28	0x736e8c2cf21c83547d6317ccd65a8c9012bb8aa115f0864d91f6ea4f73396584
233	0x0000000000000000000000000000000000000000	0x6534881f202ca7d476813b1670259a763936504a	957.36	14602701.60217860546138611	3913160	31	0x10ff627b1d8794a64eeafc3828bd81b43ddb0487a83fcfc20fd817471a91cd86
234	0x0000000000000000000000000000000000000000	0xbf8a578289cf6d9783e1457af31624135fd35cfb	2393.4	14605095.00217860546138611	3913161	0	0xb829e35f9eed6d6eef5f5eacc9880e211f37368d254b2b3de772f39f2e0678b4
235	0x0000000000000000000000000000000000000000	0xb2d1ecd686d17d831e0bde1813ad0d18c9f1c3e6	981.294	14606076.29617860546138611	3913161	2	0x2a1977de4479185e631fcd84f686ab78ee6d4cc3c6c8b99803cc85715fdda9f1
236	0x0000000000000000000000000000000000000000	0x95d738ee4e36dca69b6d3fb70e5d9ae2a1d0b732	6677.586	14612753.88217860546138611	3913161	3	0xfb677870124bcf93a44ba533ab4c8131876a8661b4bf924d4355d7ff9e6821d7
237	0x0000000000000000000000000000000000000000	0x1db81c31d95b706fa0a4d9bb40115367f08ff36f	861.624	14613615.50617860546138611	3913161	4	0x1ab1b2d9fda46338645efda14fa6be7412d57b201d6f8ea35b46f7e70c6a7424
238	0x0000000000000000000000000000000000000000	0xd19287e27635b3ec12d19fc45dfaa16188034592	3829.44	14617444.94617860546138611	3913161	5	0xe4e1af6582296d380b355e360b4b73c315ff0c6e6739f5d090356d0f794fd0c2
239	0x0000000000000000000000000000000000000000	0xe791b2472f6ce987f760ceff150aaf719c349c27	813.756	14618258.70217860546138611	3913161	10	0x2363d5325b69ef8649bdd1d2a7642df0268b09e86bd4522589e82b89dca45a5d
240	0x0000000000000000000000000000000000000000	0xd5b9d277d8aad20697a51f76e20978996bffe055	5744.16	14624002.86217860546138611	3913161	28	0x0603805e05ee70c069c6fde557c1f713d10b1f774ed13658b4f8bc06027f8e4c
241	0x0000000000000000000000000000000000000000	0x0d275e4e58ce5f60b31788403cb9e3214c9d00ac	2393.4	14626396.26217860546138611	3913161	29	0x0c92350f97f77fb89f1a3d83636853a98bdcb2a59d5039d3339355bb27cfad6b
242	0x0000000000000000000000000000000000000000	0xb4185ce7df17bd353bec605b51c0379c9149802d	47.868	14626444.13017860546138611	3913161	30	0x1291e374307b75d1e3e9d883979537db81d0a75a8f5d7e84b3bf18315e63881a
243	0x0000000000000000000000000000000000000000	0x99fd462735f6b8dee602fbaaa854b30b0fb6b4e7	239.34	14626683.47017860546138611	3913161	31	0x235c7e591addd61ace9f6c1e36442b693f4112098d710e7b1706c836fc07be74
244	0x0000000000000000000000000000000000000000	0x6db08706cbf6f682fa84d81f85cfec3ff8ce7306	239.34	14626922.81017860546138611	3913161	32	0x30022bc7068b430053d61f1362f0fc98f1f6bcf8f5818421481d20cd2fa1cb76
245	0x0000000000000000000000000000000000000000	0xf20cfb128750f5f81bf8a78b04340cc85f6acf51	3829.44	14630752.25017860546138611	3913161	33	0x3cde0d529c5aa82b098c1f7bc7a7c7588bfe34f1a80f95b56e6f6a237143b162
246	0x0000000000000000000000000000000000000000	0xb92a2ee85aa4726378adad1e0f8f1b899eb2c1f0	239.34	14630991.59017860546138611	3913161	34	0x64e33fe380cf849d7ed4a8453d91034f434afa072d30f4fb01da688741b4bc0a
247	0x0000000000000000000000000000000000000000	0xef5feaeb48d2512a34e6eba9f7e637f1b49f8254	3829.44	14634821.03017860546138611	3913161	35	0x7a640b3bbf6ad60708d539cefb8c24b993e662e5717bb15baf251ca2c055d559
248	0x0000000000000000000000000000000000000000	0x1a4230717bc953f99b9c0591e7fbd866af4e4041	3941.8185069	14638762.84868550546138611	3913161	36	0x83ee00a27624d89e2bad096d8337baeec46d48e7f056b4b7e05f1e94bd292962
249	0x0000000000000000000000000000000000000000	0x7cedd4fc7adc7a496a74bc065762c9489cfc7f04	3111.42	14641874.26868550546138611	3913161	38	0x92a99b2c13c8af18f7e96ddab1c4f5da2e2b412f7011bd77acefce96f192dbd3
250	0x0000000000000000000000000000000000000000	0x6bb40be9dca9692a885e296c5c83974178647291	478.68	14642352.94868550546138611	3913161	39	0x94d29210d0283eaf11fb31a94728c8790c01c6b6083d2268e3408da6208976b0
251	0x0000000000000000000000000000000000000000	0x004b8d39928b9318f7709599ac8d717a3e65e102	944.43564	14643297.38432550546138611	3913161	40	0xa5372f00286d478b68ca13b6e8e6a9678056868c6e1cae5bfe71a5a5abcf8d63
252	0x0000000000000000000000000000000000000000	0xa6d109f76ba3ea154f3ade4abeae1a58b2829c42	718.02	14644015.40432550546138611	3913161	41	0xb2718202d987d5f362140cfbda404600489a65907b660c88748de272dda90e5e
253	0x0000000000000000000000000000000000000000	0xf6c98233994082caadda0e60ff42970cd6c70473	2393.4	14646408.80432550546138611	3913161	42	0xb68cbbe793a3b5477e42cda2d79eab3648f6160eb926f3ff98d8e9750555618d
254	0x0000000000000000000000000000000000000000	0x78805795dc090222db3f7b00f1c1325eec40a44d	19135.639108013704102467	14665544.443433519165488577	3913161	43	0xb9601b2210cec7505520c31a93a9147226e2ef67727e77ff69a57f5af2deea32
255	0x0000000000000000000000000000000000000000	0xd90ea6bb71a83952160536b6d3d35035cfd709a2	2393.4	14667937.843433519165488577	3913161	44	0xbf89864bb38f83419b6e3e0a692896a65c4e3a01ff3158042f448df2a4fd1052
256	0x0000000000000000000000000000000000000000	0x4f817232617701bb896fc4125a61131761ee9162	5265.48	14673203.323433519165488577	3913161	45	0xc2fc0c323dbdea0598b1bf8a3e22a3b42251c9cf7f1374ae2a9da9d5fb6fb430
257	0x0000000000000000000000000000000000000000	0xcc6678195297896e36d14a844cdea910f87ce737	2393.4	14675596.723433519165488577	3913161	46	0xea85aafef81a94a7ec704ac7a5d9856fb049799d934601a15c41faae51d9855d
258	0x0000000000000000000000000000000000000000	0x00a7ea77c5412bfc0c4e3a2991222daa56801699	3350.76	14678947.483433519165488577	3913161	47	0xed67f6ddc6f7f89e1f5c654957ac69f44ec4b5f1ad312970fa15929cda14a973
259	0x0000000000000000000000000000000000000000	0x4165206ef89b5828ea9801a6acdc46187d43c828	2297.664	14681245.147433519165488577	3913161	48	0xefc6bdb380ebff4da6391fe5743b5b1f1494824dd33e1276ac4b7e5ba82127a0
260	0x0000000000000000000000000000000000000000	0xd0d411e25b06aa4f9ce7abf285ee154d2debcbf1	1196.7	14682441.847433519165488577	3913161	49	0xf2fa5b39aad3c1c656499a296604471e97f6e31168c80940060b861691580c0c
261	0x0000000000000000000000000000000000000000	0x952bd6bdf67e32d9c8eeb874ff87d4b0debf2469	10473.5184	14692915.365833519165488577	3913161	52	0x8ac163776b2c7fabf9ada52ab6b5c9e00ee6d4d45d5852eb9c703c62e394c590
262	0x0000000000000000000000000000000000000000	0x0f46d976694f670c8c894288daa8e491b2b0a049	47.868	14692963.233833519165488577	3913161	53	0x0ee18447ff882c1ebd98ec7889781e89ac34907e0e5a1cd357e7bbc30c0caac3
263	0x0000000000000000000000000000000000000000	0xdff0989a7aa5e5ce9beb83830b2b3e44d399a2e3	47868	14740831.233833519165488577	3913161	54	0x13bc4a4b52c4f690fb6261330927f7baee619eeb336b605362747f6edfb90c8b
264	0x0000000000000000000000000000000000000000	0xaefda5d9cf9393f2c572828f7a10e78e78b77ed5	10.05228	14740841.286113519165488577	3913161	55	0x18d222c55bcd17b3380a28453ad720d09c2a11e69033f574f6f870f70e4ed63e
265	0x0000000000000000000000000000000000000000	0x91a5f542b88a24474408437cddf036cfb0df7b74	2393.4	14743234.686113519165488577	3913161	56	0x1c3c71432fe448ff57f8694475b4556ed91bbb320be2e92145bdac7ea62ebbda
266	0x0000000000000000000000000000000000000000	0x90f17e9ebc30514532a6ee83c6781c7c14271dc4	2393.4	14745628.086113519165488577	3913161	57	0x22e1ecaba20d4ec9f984482e8e7471439aac6daac37b34b9811dbff22d819257
267	0x0000000000000000000000000000000000000000	0x1fd9bde7e73533e28455421df56e73de0a0975b1	22976.64	14768604.726113519165488577	3913161	58	0x3f86c2bacac4750d9abc3605a50403c09f34ac31fc366876771e7be86a05114d
268	0x0000000000000000000000000000000000000000	0x7db8cfbaf24b24bb1cc724949bec20d1ee64f99c	205.34284826168812032	14768810.068961780853608897	3913161	59	0x480063e7ff6c34b2eafc1da7dd0c1ef778e4ad05e6fce1baddf1f43ddd51f15f
269	0x0000000000000000000000000000000000000000	0xb968569c26dc5da1984e3f0ad3943088b05f8194	1436.04	14770246.108961780853608897	3913161	60	0x58a9feda7760099aee335040d87aa12b33994726b994cb554e8b090397d57dd5
270	0x0000000000000000000000000000000000000000	0x26caf000a988d28a7314b91134f017f03d80d3ff	3521.17008	14773767.279041780853608897	3913161	61	0x8b75e057c47c09142716fa245da92647bada50608d1ca3bf643f5b56b5880817
271	0x0000000000000000000000000000000000000000	0xdbcd62a4df6f193a5ac8d6492fe647461cddce82	1675.38	14775442.659041780853608897	3913161	65	0xc9ee0562635420e2ae249381f148218f52dd2af2cf51e76fb09b4fd8059870f5
272	0x0000000000000000000000000000000000000000	0x34b7bb1e4599f3452d448557c7bfa4e181ec1d6b	478.68	14775921.339041780853608897	3913161	66	0xdcf6070a7d337a710051a802296a0492e122958ed337f345dbcc0ae6c2ac304c
273	0x0000000000000000000000000000000000000000	0xbed7fc5a011cb6ac5a14fb86c1ba893b40acf1e5	2393.4	14778314.739041780853608897	3913162	0	0x43dab459e86e1f5a5b6ab1185707b9fbcea4d14fce4d1039a58690265f1e77f9
274	0x0000000000000000000000000000000000000000	0x1d758dec1a1c752f0942e4044f1c6a89742c7ead	610.79568	14778925.534721780853608897	3913162	2	0xa022847ee2ace271dac46b65d1b59b61c85c0304162229515ab7a2ce3d539ff3
275	0x0000000000000000000000000000000000000000	0x4322ef8739c74fdde93c359843982d35393fd565	1436.04	14780361.574721780853608897	3913162	3	0xd66f3ba8f95059c69b1a8ae054fb2f69aec5b2794fe3a94ebee914d6bf569555
276	0x0000000000000000000000000000000000000000	0xa9680cacf37282f96722915aeb1d9c69cc207888	4786.8	14785148.374721780853608897	3913162	4	0xa4d870484536eed0888f6eb71e92053576cccf47a81571fabcc7bed562b0cb2f
277	0x0000000000000000000000000000000000000000	0x396a2d6d374a535df417649667a8eb611b4070e1	942.9996	14786091.374321780853608897	3913162	5	0xa653270d5867ce23e0cab0449df309e0b9f33f1ab5a3a8bce5e403edee9952ac
278	0x0000000000000000000000000000000000000000	0xd123b896109ca0ca44793720600e4b1e1923453d	10052.28	14796143.654321780853608897	3913162	6	0x4645842143452f255c1b32e5080500a9496e52a4b338c2cc2510c32c112a1cf5
279	0x0000000000000000000000000000000000000000	0x3fc90b9ec3deb1712aed78fa29ef304566ad42ec	7180.2	14803323.854321780853608897	3913162	9	0xad67a2355d4bd8705fc3f8fa4671406d50230ad86529b60013b6fe324e06a3f9
280	0x0000000000000000000000000000000000000000	0x006d9fd02723f2fa0345420f5c432ef7eb5b7301	718.02	14804041.874321780853608897	3913162	10	0xb627ecd8541b49964344a92313841051eabba27e370b3afa2afe340b54314164
281	0x0000000000000000000000000000000000000000	0x54be9e55d140068ceb1fb0213bfa5c14d0b1a254	239.34	14804281.214321780853608897	3913162	11	0xca98a4b5c070f843f40bc7788de65ac6d75c65547b7d33e663782a2d31c5fb88
282	0x0000000000000000000000000000000000000000	0x2bd1f1f92b72c930925caa4caf8700581ca58400	1914.72	14806195.934321780853608897	3913162	13	0x3cab2aa3da8e4a69245c1203e3d64959fb0ebc588b8dc31e56641b532a2c9718
283	0x0000000000000000000000000000000000000000	0xf2c0fde76732a654d88da51f5afee644d05d9d0e	2393.4	14808589.334321780853608897	3913162	14	0x12c511051ec92ac4f3c0dc5edb486b6b02b0ad70aac8a6d4017f2a9f87c17b57
284	0x0000000000000000000000000000000000000000	0x10db0c978668616249dba305c85166b4f081319e	19147.2	14827736.534321780853608897	3913162	30	0x4edfddf45546880a0d699938d145d43dd7cec7d01f3ab82b4918c65272015eb9
285	0x0000000000000000000000000000000000000000	0xee6f29222f485158901473486a6f81a8ec71002f	3829.44	14831565.974321780853608897	3913162	52	0x8aaec1118384f5cdfb000de5c44023f340e176d84a3bfb232ef1ae576a5dec63
286	0x0000000000000000000000000000000000000000	0xc00c924402f91dbb13599a71e0da36509dc245f6	37337.04	14868903.014321780853608897	3913162	56	0xf9f42ebc34c58cb00f8cf518efe15bcb6e1dc45c8db41ca19f104bad34bb6813
287	0x0000000000000000000000000000000000000000	0xe80e7a53881e7e180b7885273590f4e8d5c87c0c	4786.8	14873689.814321780853608897	3913162	60	0x1b5d658d8f4de81f4bd305173a2abc26633c4c76d544c380d2f203fb0b844e58
288	0x0000000000000000000000000000000000000000	0xd8b1ebc8dab48c2a12f9f9e16d9eb7d125d39cfe	1436.04	14875125.854321780853608897	3913162	61	0x29624edd244374a814cdf1e3f5008e2a0020d3f26d273cbb6fdfad5b17a0f8e0
289	0x0000000000000000000000000000000000000000	0x0fd20d0c6e8e69f1680850106a9dbbc5f5573ae6	191.472	14875317.326321780853608897	3913162	65	0x7a24ef795e0a10a805517d0b76fb9f13d2ad43ae4d47648c06ab7743afd298be
290	0x0000000000000000000000000000000000000000	0x3a3a04cec5f76985058e3148ef9f0985434dc2d4	2393.4	14877710.726321780853608897	3913162	68	0xfc8e8f6f5637930dff2cb33ec6f30d4fd7e894aa071718e798165f3f57316c37
291	0x0000000000000000000000000000000000000000	0x8fd8578bdeb22ab757902cf54b8390abb99a731d	57.4416	14877768.167921780853608897	3913162	70	0x04d6bc876a42a3bf3808db54d4d4aa8632c2a507f684285563ae515150ccb90f
292	0x0000000000000000000000000000000000000000	0x223a0509d27a068427985f261c984cedb4e4018b	3829.44	14881597.607921780853608897	3913162	72	0x13adf218dea9a5b46ce224edb1ecc7447b7908cff62a9abcac22535ae3578379
293	0x0000000000000000000000000000000000000000	0xe4cdd6c3ade138f1dacc70e3589c4653d10bb771	3446.496	14885044.103921780853608897	3913162	73	0x19ba531e2de9fb824b388e3cc99083caccdd28b4618ecdfa78e1c2ccd02fb047
294	0x0000000000000000000000000000000000000000	0x6e725111e66666d61ea46946ded638a5ffe6f2de	847.2636	14885891.367521780853608897	3913162	74	0x1bb009a450d3bbc128115b861781436f0398eb6af0eb8982172bb6bcf5ee01bb
295	0x0000000000000000000000000000000000000000	0x95446c5d16a4712753e3daaf77a669f754bbed7f	909.492	14886800.859521780853608897	3913162	75	0x22b81f72d0e3aa83de28c481100103ff52325fa7c1b3d0f376a730da0d349cfa
296	0x0000000000000000000000000000000000000000	0x939a2d41e5b8410e1d4f7a058bf9fec759382069	1388.172	14888189.031521780853608897	3913162	76	0x2d50df82b497b2796fde8abb99108ac3ad360e128e03dd89a83764b0cafb7668
297	0x0000000000000000000000000000000000000000	0x9f48209b447c3f14d7b2acdf793b6ee14bc7fb9f	19147.2	14907336.231521780853608897	3913162	80	0x5fabf9cd32bf1b6e9a30c9c7b2aae4aef91521f64d447ef6581f9cd73533e74e
298	0x0000000000000000000000000000000000000000	0x6bf5fedc67ae13a2278db308b3c42e34300aaeef	239.34	14907575.571521780853608897	3913162	81	0x6f2930dd058a7132d5a3d0fab13674d0a43ee1abf6ed0aa2be11754e63d546a4
299	0x0000000000000000000000000000000000000000	0x729ea64b1393ed633c069af04b45e1212905b4a9	47868	14955443.571521780853608897	3913162	82	0x7ada7ab87aed0190328f8cbe056b1f5af4cd925accd795c72c6b26504194b7b0
300	0x0000000000000000000000000000000000000000	0x181303207832bfd3f581f96af3ef401798b02747	1436.04	14956879.611521780853608897	3913162	90	0xca2761b0cb4c0e745b1d20ed3c28538a1c1f97a4d0995a504d7a9eb191b35e6e
301	0x0000000000000000000000000000000000000000	0xa09c71abc6ddcfeb38b68eef7d236d0f4b94c11d	33507.6	14990387.211521780853608897	3913162	91	0xce07695314c1f8a12aaad3b912b0c2f168d2c70b1ed488b199633f1e32821bea
302	0x0000000000000000000000000000000000000000	0x2a8ca1e16df6b6122d56403412cf2290f099c427	2393.4	14992780.611521780853608897	3913163	0	0x3cb4834c37612ddb77419663f90447cb73caba3144744b28d1463cd5e70829c1
303	0x0000000000000000000000000000000000000000	0x614c6bdb1a084e808c1bb6623628c7d1db77e762	10643.4498	15003424.061321780853608897	3913163	24	0x8d22643de22fd60ecd72504416389e2bb35195776fb052a15937f85f694457b9
304	0x0000000000000000000000000000000000000000	0x6e5f908f842ce9e8997ae7c6240ae30f162a5a24	47.868	15003471.929321780853608897	3913164	30	0x112819384592569d2de609d370e77b6a4e30979779aa8f3b278a314fe575b0c6
305	0x0000000000000000000000000000000000000000	0x30a36a407db710dbd6e208c6107e27b4cd2d73ba	2393.4	15005865.329321780853608897	3913164	31	0x128031f015f74f35833406de527617d9bc7ecedfcf45b83d3e2f99e1faaf4ac0
306	0x0000000000000000000000000000000000000000	0x1641cf1b4cf253eb11d9882e956393a0bc62a414	1101.746238215670286284	15006967.075559996523895181	3913164	32	0x0e74896658010855c51f35d3ee8381d8ae7a5a5f9c95ee7c6331f71aa0ef4f1b
307	0x0000000000000000000000000000000000000000	0x36c7a54c65d9668c0703715763273bc2e6f8f280	33.5076	15007000.583159996523895181	3913164	40	0x1c113e6de7abb95e8fae2fd0ab5e7635bbb038fdf3de47bb1a4acc66bdd8d7b8
308	0x0000000000000000000000000000000000000000	0xbc3ff3426fb90932bad89364b0000aaf735fcf79	4786.8	15011787.383159996523895181	3913164	42	0x75fbbb5241178934fe7b56ec0e311cc909bc74c7742129cd1f5f1d0798d267e1
309	0x0000000000000000000000000000000000000000	0x1916a0f94baf2219f36cbbaa1e2e705ebc531682	478.68	15012266.063159996523895181	3913164	43	0x009bc8d96015efed8607cf4eac74af8485dd836bd5489bd7773d0b108635b084
310	0x0000000000000000000000000000000000000000	0x25af88fb595ec3b94d7803a58c92a6ff8b5c26ca	1790.2632	15014056.326359996523895181	3913164	46	0x4ed5973a8ccd06014c697e5c63ab83fb0caf47d2138ca81d827fd6efd4d048f1
311	0x0000000000000000000000000000000000000000	0x88ad1ea01e9635ecadcff10a19c05d1b1cbe90b9	4786.8	15018843.126359996523895181	3913164	51	0xd56ec8955ece8b7ebf041d81e9c543291385597920aa57cf74874cd93dbe2b90
312	0x0000000000000000000000000000000000000000	0xd2a50fa017764ba4b2a54f7da85c66f9a6ddcc23	478.68	15019321.806359996523895181	3913164	53	0xf96ab076aface0614837bdc7af1b91f41fc6bf523996339f36ef86323e8cb443
313	0x0000000000000000000000000000000000000000	0x0d2e3476a33ecb7ac749a24ab70cc510369e6d69	7175.4132	15026497.219559996523895181	3913165	3	0x51016435c2863df9da4aac0f1b01bddc7d72b4438354488dbe88321e083cfbbd
314	0x0000000000000000000000000000000000000000	0x7c4979a3973d7a80b9de250af88817efaa06dcfb	7180.2	15033677.419559996523895181	3913165	5	0x76dd66e47932bb32a5dcef712dcb88c1f76a403b262298e535d60f3f4588b29c
315	0x0000000000000000000000000000000000000000	0x9b388ce5e6089f53de298e2fdfe830bf43b06a17	1100.964	15034778.383559996523895181	3913165	6	0xd2a93a922f15a72acc5d2e423ac12c2fe93aaf227386ce0ab37c31117cd2bf69
316	0x0000000000000000000000000000000000000000	0xd490323bf54e8434f2ec3e90640b14d48f432f79	957.36	15035735.743559996523895181	3913165	8	0x7f3968dd2f4b39b271645aab476315eeb2a7fcae7c224c8c716d357971a1b8d3
317	0x0000000000000000000000000000000000000000	0xb33695dc93cf8b769a3e3e08578cbf8dfdaab1ce	478.68	15036214.423559996523895181	3913165	12	0x99df0de28becec8d0f3409c0d680ae344464aa82761b3be0e933826d3f69f94b
318	0x0000000000000000000000000000000000000000	0xe02c74aa415aa6742798d7fc656a21b88aa4fa47	14.3604	15036228.783959996523895181	3913165	22	0xb279bd498a4812b736911c1e0ef0011c733dbd0dd4ed9c3a25c518a414b7f6d3
319	0x0000000000000000000000000000000000000000	0x615b9351251b05a8ec82b97c667fe31ea4a1ed16	1579.644	15037808.427959996523895181	3913165	24	0x34c48ed63077fcb2e642c92c5519c0d22d8d783fb0545070a641ac20cc547db7
320	0x0000000000000000000000000000000000000000	0x8204da016d319506c931b70f6ad10219c55bd2f9	47.868	15037856.295959996523895181	3913165	26	0x033bc0ae5ef136d1aaa49b0e0b84086001ffc06a64994e5d493838eb3ee1df47
321	0x0000000000000000000000000000000000000000	0x81334fbd096c9f293610ef7850aac20632dd5c8d	1914.72	15039771.015959996523895181	3913165	27	0x519ef58daaef322f4d139ab22c7e1fd0ec9ee92a11bcec8f06f1bbab235258e6
322	0x0000000000000000000000000000000000000000	0x6257018fe20ff3dbd6c7d1f99fc0569dc17895c1	1866.852	15041637.867959996523895181	3913166	1	0x8ad1c8fb79e5adf21dcc3cf355198bf25d53284e6da24912d3bdf4d01838d93b
323	0x0000000000000000000000000000000000000000	0xd0d411e25b06aa4f9ce7abf285ee154d2debcbf1	957.36	15042595.227959996523895181	3913166	5	0x32e70409f8933e296740291a47f8870e90224ff581b8131b65b9d772c2fcfc85
324	0x0000000000000000000000000000000000000000	0xb239e04f9e33fac910e29d74ac1c064a8164345a	47.868	15042643.095959996523895181	3913166	6	0x89e59af45cd27d57c3a132024b02e0c5ee57967d7196aa6305f6e508eeac3b51
325	0x0000000000000000000000000000000000000000	0x6b5ecaf8e905897bb0ec6a293f83fe52873bd46f	22.97664	15042666.072599996523895181	3913166	7	0xd3c5757480881a5197eb159e8771eaf38f5f895feb3056461d42bceae5009953
326	0x0000000000000000000000000000000000000000	0xdc0f9d8e1251be93a3ec2ff618adfb73abefd689	1364.238	15044030.310599996523895181	3913166	9	0xecbd9a394be3195d17f6fa9f6efc2c66bd28eef330dac5e8569f9e8419282884
327	0x0000000000000000000000000000000000000000	0x9606adbc827d140caef8fc3292b40db0039300da	2393.4	15046423.710599996523895181	3913166	13	0x0f65467c78e3ecdd8d28c14978c83b6757c7409112924b8203681df9f0685314
328	0x0000000000000000000000000000000000000000	0x8aee3359529c6ad3ec90db72eea9328b740db302	110.0964	15046533.806999996523895181	3913166	14	0x50b926efb671e9eac2d942ab7e4ec59c032943c3120be6da56b3d7e704f8e2af
329	0x0000000000000000000000000000000000000000	0xd8481a240688272a95a99fbdf519e10b14389cbc	13403.04	15059936.846999996523895181	3913166	15	0xd3433eb2beb67b04ae598daf81da6e90f086f8c8655668f6494ccf412ee3b62b
330	0x0000000000000000000000000000000000000000	0x22c20f41378953eade9b659250441d5798d77daa	38.2944	15059975.141399996523895181	3913166	25	0xb164d81babf99845568852d377d1d4c519f96d82a8043086fd2a3b85ced6a862
331	0x0000000000000000000000000000000000000000	0xdf7cc75aa11e98dcf69756617c8eccfc784ac110	239.34	15060214.481399996523895181	3913166	36	0x583b469f6b11a30cffc59bf4f0b05e2a65e3c8349337687eed5208dbd0dcc41f
332	0x0000000000000000000000000000000000000000	0xabcc0fecfa3d08ccf356413759e299eaa43bec60	239.34	15060453.821399996523895181	3913166	38	0xddb7206adeb99892e13852cbc457cb833c35adf18776c1042eb7583972b6ac89
333	0x0000000000000000000000000000000000000000	0x151d8348f687f7340275e692d452106a0fb0903e	1851.53424	15062305.355639996523895181	3913166	39	0x30a0f2bd6498be9668a011d65d68c11e06bede3dc995cc9b96f428b987f2fd5d
334	0x0000000000000000000000000000000000000000	0xe6a065048bc03ec785c7e63c27561e54cf3c49bd	19147.2	15081452.555639996523895181	3913166	40	0x5adc159297110e61dd92ea79acb7f82d81b051a1f95888a6b45327ce8ad1ce3e
335	0x0000000000000000000000000000000000000000	0x3de69bf345bf95c58f7ad37dce9633832d9d2ef2	52.6548	15081505.210439996523895181	3913166	44	0x8ff40b45407a3c22310ab98f23d9271cffbb85b88d773d5f379cb42bb0362d21
336	0x0000000000000000000000000000000000000000	0x25af88fb595ec3b94d7803a58c92a6ff8b5c26ca	3.35076	15081508.561199996523895181	3913166	47	0xfb0dbc6874734e79c1e60e8de2020b1b7154af73045394508594a157b6911096
337	0x0000000000000000000000000000000000000000	0xa5cd7a9ee40aae0b3548e537e9e5a59d1a974a50	536.1216	15082044.682799996523895181	3913166	48	0x528c61524faf7c8b414f90d619f0f689c07dbb5728cad7cc07fd60b2c5b92c82
338	0x0000000000000000000000000000000000000000	0x35daa6c87c5495cefc9dd9ba070ca5a56f9ec6b6	239.34	15082284.022799996523895181	3913166	56	0x2f1a1d10fb1a4eddee7eda5c7e8b1d20b5507de50df360c4a0d086944f39fe2b
339	0x0000000000000000000000000000000000000000	0x374923719304aa24252962e3650a1e9bc7865b08	5265.48	15087549.502799996523895181	3913168	0	0x1f8dcd5a3c68c60ed171f0dca1fd65e29a675d0e1515a6cddd497cf4a1ae6d51
340	0x0000000000000000000000000000000000000000	0xf4178a2e1c8da1888d07d4a1f8b4d9566fbba214	2393.4	15089942.902799996523895181	3913168	5	0x2e87dd1961bac34f38bdd8e6bc5c76e8aa6c9cd6455e5b2affbca86bf8f8641a
341	0x0000000000000000000000000000000000000000	0xa8a05858d35e3f89f8dffe457ae90595495f0726	179.170727599783744408	15090122.073527596307639589	3913168	6	0x3a79c805af406fbb914fa84c1afe8ba42fa962507d03199fb86a7204d60bdc4e
342	0x0000000000000000000000000000000000000000	0xa5659c0a37a63c2cbada7264ca08cd76ed06c347	9573.6	15099695.673527596307639589	3913168	9	0x9a56994fc5304e38d09d4b104360ee4b451c4cc1b4825c1f6727bc4aa95e8d24
343	0x0000000000000000000000000000000000000000	0x88e4c34f2d290d32761bcd68e874e018d3355d4a	202481.64	15302177.313527596307639589	3913168	10	0xa618c5d1e3b96b0806b750e08ffaf4333ceeca929fbc4e4f7422376a98fd636e
344	0x0000000000000000000000000000000000000000	0x76b994eeb57650dec3f3fabe29452719d1ef9df4	2393.4	15304570.713527596307639589	3913168	11	0xa96cfcf791845cfcb4e77122adad74837372270def5abcb23ef393813f753b92
345	0x0000000000000000000000000000000000000000	0xcf0489ae7bbf3b7321841f3ce9db682a6b0cf612	957.36	15305528.073527596307639589	3913168	12	0xfe64629661482982e92e487dc954efd73f92750207b0706fa0b8883168fda787
346	0x0000000000000000000000000000000000000000	0x7ee4cb188570163184a3c6c2f322531d25fcb496	1436.04	15306964.113527596307639589	3913168	17	0xa750e30da04f0e746b8233d76f2619b57e2c3e94cd4009281466c876cbf14caa
347	0x0000000000000000000000000000000000000000	0xd5f4d9d68aa7ce1f50e3a902db3f26735ef9429f	564.8424	15307528.955927596307639589	3913168	18	0xd7cea3aa2e25308f0a27b18357da022865d0b5e60de6bc9f88c5a300004064c6
348	0x0000000000000000000000000000000000000000	0xa787fcafa1fd4a996261061447a60cced33f8075	1723.248	15309252.203927596307639589	3913169	5	0xfca6ec373959aaa50c5a7dc0d4af2ff52f7f8832af4cb403b7200a2925909eff
349	0x0000000000000000000000000000000000000000	0xf0e4b3a7e8743c1e7033884be304c9c6125c6fa7	495.91248	15309748.116407596307639589	3913169	6	0xaeca50d6c0bd2f0857bc2001ee32b460cb84cc56b2614474c7b5d76c0aac5fde
350	0x0000000000000000000000000000000000000000	0xb4e6080e9b43515cbe8d79fbc7fc4f0c60477499	339.8628	15310087.979207596307639589	3913169	9	0x401a9f32a8919b59720cb6f2bcf3ab9ab9363493d7c8d555ee3038f695670a0f
351	0x0000000000000000000000000000000000000000	0x7a04930453967d01193c5b23907bb493cd52bddb	382.944	15310470.923207596307639589	3913169	10	0x52d2b63a7fcac0261b0c4b06e848a1797431f1b62c51c8a73838aaee5ddc2bda
352	0x0000000000000000000000000000000000000000	0x42cd10ecc63b1e2d5b3c1a7e3f8139477ea94534	143.604	15310614.527207596307639589	3913169	11	0x7b9f3a5f3842387cc829c02347dd6c9b12d0e1281ff4971623deff48a4d54ab7
353	0x0000000000000000000000000000000000000000	0x584d71aac1342a29e5ceac6cf39b334c35936d4a	382.944	15310997.471207596307639589	3913169	12	0xe6551cf6840c43217902dac366a727e9e725bcdd36c9831e666fc4d380fe0a98
354	0x0000000000000000000000000000000000000000	0xcc0c30188a2981ca46cb252a4ef43dadd5546145	239.34	15311236.811207596307639589	3913169	21	0x03bc53ff293ec920f865905be390d2b457e8eb5671b5a967c8775e4ed4220337
355	0x0000000000000000000000000000000000000000	0xac80e23a6c04faa9775e61f324920c358040a773	957.36	15312194.171207596307639589	3913169	22	0x5a1ba790a7cb8db5811b71410b5e2dc273d5b0118128fac8871173389f5bea56
356	0x0000000000000000000000000000000000000000	0xbf3727e2673564f58e5b9883517cf0a2183482f5	88.07712	15312282.248327596307639589	3913169	29	0xb10cad830c336639e63434b64a50fca8afe57d80fab29cc318b67bc6bc065f3b
357	0x0000000000000000000000000000000000000000	0xf8725e51f749a42d6d46f6a5e3666bd86775e080	8137.56	15320419.808327596307639589	3913169	31	0xdb43dce6f04da0fc690abab7b2dc0a6565d7ffb36c4531e72d54259da3213c3b
358	0x0000000000000000000000000000000000000000	0xbe450d10777dde1f9015db13897127b788f495fd	5744.16	15326163.968327596307639589	3913169	36	0x141e7c7042a8001926219e0c11ba735939599db4568ca4cdbe5b47398e913fd6
359	0x0000000000000000000000000000000000000000	0xb139302f4a8d9eb58743adbbc077931054bffaab	114.8832	15326278.851527596307639589	3913169	48	0xa562dead2b7f6ad2dcad9649d39f1ef69c68a17403195d840bcef641316b9098
360	0x0000000000000000000000000000000000000000	0x277d002eaeffbeff8ae4cd2875b99ef7b325b8c5	76.5888	15326355.440327596307639589	3913169	52	0xb74204bbbe72391c62e7702bcb6f5dc204efc15e5e8bd9449e752be788d109d0
361	0x0000000000000000000000000000000000000000	0xcd7a80626d87d0b7af6e728c64e6ba57764142f4	373.3704	15326728.810727596307639589	3913169	60	0x062ea57ddd0ddb0cae2149050d0e84a6a3fb776681af45e09197ce2b96fd7fc9
362	0x0000000000000000000000000000000000000000	0x145c5af23b708a2791cbe8dbe1e0e35e39be7bc1	478.68	15327207.490727596307639589	3913169	66	0xdcf23b74ac190d371163f22fb7b1d7d7abbb6b292306020b408ac272b80f7534
363	0x0000000000000000000000000000000000000000	0xa1262c7f16acc148719675c92591d608c61eb166	478.68	15327686.170727596307639589	3913169	70	0x8974bd0845c1cc4acfa2e7a2ab302d59860291323deadcb2fc95e6c098fadcef
364	0x0000000000000000000000000000000000000000	0x002299fa983660ab72f80d6ef5b92f5c63401994	478.68	15328164.850727596307639589	3913170	3	0xc6c16792179aa8385781418ce186c82871c45e31a7c7c3f2d77b02a27f7cd2b1
365	0x0000000000000000000000000000000000000000	0xe4580938d81f89a22ffd58b2145952d33a67d066	1962.588	15330127.438727596307639589	3913170	4	0xd64115798115f5f071f61c5cc9eb367774dc665445ab4dd20678b7f4f564ce88
366	0x0000000000000000000000000000000000000000	0xccf33634d86bcea52717095406fcc984dddb219a	718.02	15330845.458727596307639589	3913170	6	0x4d8d313e7b12d5c06c0d3cd6b8d2bf0cc6c24847fc1b37736e2854cc4b5e4fce
367	0x0000000000000000000000000000000000000000	0xd1429240592be4032d5785cf90ce3238eaac1058	4786.8	15335632.258727596307639589	3913170	7	0xfaa2099b91289ea18276ceab5d802c15fae084c5e8907cd73a8d3781985b68e9
368	0x0000000000000000000000000000000000000000	0x5e1d61e07e982aedd99cfe1fd72cbd82f0bc2d35	95.736	15335727.994727596307639589	3913170	8	0x0f25c1b18cc7295c638b9a885af52b8326fee09560665d7e85f579b7cb0fe335
369	0x0000000000000000000000000000000000000000	0x00a558a35b15ab94da89b181a087aec9729fd8e2	0	15335727.994727596307639589	3913170	10	0x96c026113cebec2dfb3e3f6a58c22e36caceb8c52b4443a5529b6bfe6e9eb354
370	0x0000000000000000000000000000000000000000	0x94337a2880725312bd24766894d375dcf6568556	1436.04	15337164.034727596307639589	3913170	12	0xb1699e0d8a5254906b3c000681dd40986ff40162152bd27e495b6e64b890ebee
371	0x0000000000000000000000000000000000000000	0xfb740ab28b8cfd4c2e0baacd017c3ddbadeee58a	1914.72	15339078.754727596307639589	3913171	26	0xc18bffb5b7995bfe7f9db0e2f75a3782f5a2851cbb9c999d8b5624a8de0f119a
372	0x0000000000000000000000000000000000000000	0x8bbac3e58c628add0b59efc2aea2a06eaed9a311	19147.2	15358225.954727596307639589	3913171	27	0xa4bb561c1f4d1b703475ac8be4438ee17f36eef185bf73ff69239626e1177167
373	0x0000000000000000000000000000000000000000	0xf603629ef04acba57441159ec089a5123385f8bc	95.736	15358321.690727596307639589	3913171	56	0x2283856b9628e3a6e34997f7b73d761451f760281c3c21d445d5af60ecb4f80d
374	0x0000000000000000000000000000000000000000	0x0c9b0b022bfd43093174b54ee4bf963e32934921	957.36	15359279.050727596307639589	3913171	57	0x24df4cd7e1733520b47812af94d324931ddcc9ae8fccd4388efb509ecb73fc4c
375	0x0000000000000000000000000000000000000000	0x406a4c8a1f5c5db522a1292901d6d52feaaef599	478.68	15359757.730727596307639589	3913171	58	0x5db681bfc4076656f26b8ab53ba71a30346883fd80cf87164e5b5bb97018138c
376	0x0000000000000000000000000000000000000000	0xcac98d17973d31d3834b2c76626584bec9c7234b	574.416	15360332.146727596307639589	3913171	59	0x97db51b5d4348ea61f10a8cf15bff70aa0512f708eabef2da5fa8c610a2812ff
377	0x0000000000000000000000000000000000000000	0x63ed8dba9ff7656bd366cf4335335d49bbb96265	6940.86	15367273.006727596307639589	3913171	63	0xe5232f755d8003bdbb753cefb0a0db633f31bd95416e4ae3c81b3c1fdf7117e2
378	0x0000000000000000000000000000000000000000	0x3a97f0d752b8c0b6b8d3d1211af1a4d639ceab0e	95.736	15367368.742727596307639589	3913171	65	0x438c326dab6a9d16909f340e24c41a342dac5fbebee3165c31b6f4dd76370368
379	0x0000000000000000000000000000000000000000	0xae3c855a1166c71254823085f04e6d699281ff36	382.944	15367751.686727596307639589	3913171	71	0x2b207f7d262cde76c546665747c5cb71de4d3f777eb2c86841c280695ffafd9d
380	0x0000000000000000000000000000000000000000	0x2cd93c5e957b49704fd2fee96deb0ad2563b3c80	287.208	15368038.894727596307639589	3913171	72	0x33625e41e5d3fdf2610a7303eae56aaf6baa9e6e0c498bbe2d2659b2ed50684c
381	0x0000000000000000000000000000000000000000	0xfa454d07770b9943822651a5be2ec4981406ea18	478.68	15368517.574727596307639589	3913171	74	0x3b1afa74a5bad3e440a892f067e9bc0dd61cd6e914c54243ee79a61e017113e9
382	0x0000000000000000000000000000000000000000	0x729efd9258fff6cd1dd3148ff60b79f850f0d162	957.36	15369474.934727596307639589	3913171	76	0x4dbed38b0bcc2196f595ac6af9af000162ffb37859e2a6fbcada8bfbc822ca9b
383	0x0000000000000000000000000000000000000000	0xb819ba59e00184a6d6cb657106056251e10a8eeb	47.868	15369522.802727596307639589	3913171	77	0x51ea759169258242df13de260fe47082b9d3c9b194c620630c44a387c167005b
384	0x0000000000000000000000000000000000000000	0x18c043890b9d2daf51d4d4594707cbe9ad062cbb	167.538	15369690.340727596307639589	3913171	79	0x66ac2b155486db48fb6c4d0e05e2fd300bd8575e9ee7498d25a690964ee03eea
385	0x0000000000000000000000000000000000000000	0x10ecaa10f4d34f724834b0886d8cbaf88384c82d	9573.6	15379263.940727596307639589	3913171	80	0x6f59c418d7cad1a318cfaabf9a4d9adb32e8506ebdf5911454656d0681e487df
386	0x0000000000000000000000000000000000000000	0x0cf047d6bd49d68572549cd0de77d16cdde3ec2b	775.4616	15380039.402327596307639589	3913171	94	0x04619610558694b7e9937cbad04cd4ad6593fdb241b3ffa3abb896ac3238ada5
387	0x0000000000000000000000000000000000000000	0xdeb93784464affe4dec08f9e63b9177d77ea1619	4786.8	15384826.202327596307639589	3913171	98	0x4ef6447d0d917d569b8544ad34f38abda4c27c2a258dade426694c6732fdc0e1
388	0x0000000000000000000000000000000000000000	0x00199f883058de95768ba805463eb8f6377ff270	4786.8	15389613.002327596307639589	3913172	6	0xdf14dff7d46e909ed35f78bed505dca00a15f9e6eed26a4a66f1c4c3c6598da5
389	0x0000000000000000000000000000000000000000	0x95c891f82bed97e307e333820b899e02a992ce99	4786.8	15394399.802327596307639589	3913172	19	0xf8ece6ad4fa527bf7d3d304cccb08031c87e7c34585069d7a9bbba955ce9cfe5
390	0x0000000000000000000000000000000000000000	0x121231fa85c0453947732b1e902dfafa04c71563	957.36	15395357.162327596307639589	3913172	23	0x28d0f68213c13a69d9a93c218c560a317c7d6b7369ce8add090190ed15cc9b0e
391	0x0000000000000000000000000000000000000000	0x74303b81beda2874e4a918a5ea0f292ae89794cc	57.4416	15395414.603927596307639589	3913173	1	0x83c432627ca19a19817b6ff3e50fec3ebef2805915224deffee11ccc155ee7d1
392	0x0000000000000000000000000000000000000000	0x8118d2f274ca941fee1c0b378c13c53de080c3a7	335.076	15395749.679927596307639589	3913173	3	0x1b5ddba84d62943e3c96a29e0bc98a8fcb89a9bd93888c9ad8c1c323e899dcd4
393	0x0000000000000000000000000000000000000000	0x4170decc126fe34f9392cf314f9ebfaf2cadd0c5	2393.4	15398143.079927596307639589	3913173	4	0x3d4e4bd252cb9224617cba7fdd376d19c42bacf5367039c3e0a4c7238cab616a
394	0x0000000000000000000000000000000000000000	0xdb47ae47f24cce24381ddd774d9def66012f435a	1675.38	15399818.459927596307639589	3913173	5	0x4597aa41446406b09201896ba899e1ef271b5efe180ab1382faf83a7583021c9
395	0x0000000000000000000000000000000000000000	0x5ecf48a02fe28af80f38171e3c593f9d8e537498	478.68	15400297.139927596307639589	3913173	6	0x7f1e926b033dc715b7666b8f27a395226ef088be4327d49e3947a291ae230ffb
396	0x0000000000000000000000000000000000000000	0x004b8d39928b9318f7709599ac8d717a3e65e102	1912.3266	15402209.466527596307639589	3913173	7	0x83fda6a656a81e9d1894f537dc9f9fa68cd8cb56d44c714fcca0f4d38364bc12
397	0x0000000000000000000000000000000000000000	0x87144aece4b847a01436a968b5c20616ea068099	478.68	15402688.146527596307639589	3913173	9	0x059c0ea58df8e0383539f8a5ec9eda8e98efa355c6e9b58e7d797818f8e822a7
398	0x0000000000000000000000000000000000000000	0x00a558a35b15ab94da89b181a087aec9729fd8e2	9573.6	15412261.746527596307639589	3913173	12	0x001860759661a51e96c7c3d21255d81a53c697628f3da2a4fc9e73f6539981a7
399	0x0000000000000000000000000000000000000000	0xfd1931ca6fd0672f582985377c76c93757ea026a	478.68	15412740.426527596307639589	3913173	18	0x37edfb84f6cdbaec8a6e48290aacedf8002eaa6cc9e5963050fde44a6fd8b126
400	0x0000000000000000000000000000000000000000	0xdf7cc75aa11e98dcf69756617c8eccfc784ac110	239.34	15412979.766527596307639589	3913173	30	0xb9f783fb521bd1ed1c0f5e1f3254fc1c2bc4d8dcc3b1864a5fb071c8a21c8b93
401	0x0000000000000000000000000000000000000000	0x540c208386292b27f2a9bce7147f09b27c71dab0	239.34	15413219.106527596307639589	3913173	32	0xebf484bfde84fd6f739d1080a390c9720c78c46b9752350777d04a47ff3eedd1
402	0x0000000000000000000000000000000000000000	0xc3cbda103fcd73a630a8ee2689f2d404b7c279b8	239.34	15413458.446527596307639589	3913173	35	0x635ccd6da6bd753074d1dd7f1a3129b26c81d5804c20f8e0664c8f8b7e7cb580
403	0x0000000000000000000000000000000000000000	0xbf2a6bd8aa25d6ccbf5cd67dfb50626bc03695d5	982.25136	15414440.697887596307639589	3913173	36	0xbbc126d542a72c400dd8dd6e9c98bfed49d7a0fe6c8ca57cf74b696be3b3361d
404	0x0000000000000000000000000000000000000000	0xa0feb97edb1f6b540d040620ec21b763501adea3	969.901416	15415410.599303596307639589	3913173	39	0x16a0fcbfc3c32867f6a885cc53b57e3dfa797544b43090a98b57da7bf973f3db
405	0x0000000000000000000000000000000000000000	0x3cdc8c4b740c3ee9be8c5e95b7b98371d13b8658	1436.04	15416846.639303596307639589	3913173	40	0x2b1783b7f21d3ad7a84837f7e944e82d4761b8ec944ce3d4bdb7c9cb16a69c11
406	0x0000000000000000000000000000000000000000	0x502dff4a99fa2684c89a99c0310c07dab4a93b1f	2398.1868	15419244.826103596307639589	3913173	43	0x8cb5507c1bcd0c7761877fe0e8def9f405b7617c715a1cbee59bbd1b73c3f677
407	0x0000000000000000000000000000000000000000	0xe50197d5747e3e90d9e8ad0a624ba2b14915af50	942.9996	15420187.825703596307639589	3913173	45	0xd56b7deec7d12abab5712fece8507efc61594e3b163e38a56131b1dacd69b8f5
408	0x0000000000000000000000000000000000000000	0xb53c148cbfb8ac90fc8bfeb1cb2789f9235a0711	239.34	15420427.165703596307639589	3913173	50	0x858ff1dfa755261bc4d261fb0310257751d172d44248f363f3cf6c2bb6cfde21
409	0x0000000000000000000000000000000000000000	0x541f72061b493d9df4e2e93de2f743d23168bdd3	47.868	15420475.033703596307639589	3913173	51	0x82c099c317469a00a0439a0e9bcbfe3cd33c9fc38fef57b7f123020e48a492de
410	0x0000000000000000000000000000000000000000	0xb359ad4af411edea51d8bd7e484b3fa007ed5469	478.68	15420953.713703596307639589	3913174	0	0x9aed14192b37abae501857cf8efab29a366195f8c77dcb88d15d3cbe996557e5
411	0x0000000000000000000000000000000000000000	0xc37bf0eee05056c4c190300aeb942c62cf3d5772	957.36	15421911.073703596307639589	3913174	1	0xe7109d5cc88e0aa00bec3e69a0115311d9f93c5304d8c1800b329e3db1be047b
412	0x0000000000000000000000000000000000000000	0xd60a898dc9500a48d440e5f82b9a104581bcdaf2	478.68	15422389.753703596307639589	3913174	3	0x912b9e14ab973200de300ec3383aefb50f9cda43c79f5b76954c363ac205496e
413	0x0000000000000000000000000000000000000000	0xb1fbeb3273ad482ad276d4cdcae560ce80e41394	3111.42	15425501.173703596307639589	3913174	4	0xc2603abbb80731b11bc2863a4fca61f5f25c51635f2a0e051b1a9374ec9ab58f
414	0x0000000000000000000000000000000000000000	0x121231fa85c0453947732b1e902dfafa04c71563	478.68	15425979.853703596307639589	3913174	7	0x140e958dfffd53749c687fdfa316be000fbf53bbb62675bd8d085f3e35cba07b
415	0x0000000000000000000000000000000000000000	0x2e04230b7c55a94d72bea9b00d0fac5d89357dc2	476.54676258	15426456.400466176307639589	3913174	22	0x3ea8aa479996c4d0c383e5fb80a0ff6c31f327da5d7a5a4920c52148e41598f4
416	0x0000000000000000000000000000000000000000	0x66a9f1954802d7383e2da79ae406edbdd26b8d26	9573.6	15436030.000466176307639589	3913174	23	0x51ad16f05716aeef5d4e145bef20a829ac958561545b504bb84a203d65d0830c
417	0x0000000000000000000000000000000000000000	0x600eb539f13c35c0ab49e95f01b6d431ec185641	478.68	15436508.680466176307639589	3913174	24	0x659e4c2e8e7065b105beaa0681110124086c210dc97f29e7f16a3efe8ac77d59
418	0x0000000000000000000000000000000000000000	0x0c2ce00e722bd42048c429842f9e1aaf42590140	440.3856	15436949.066066176307639589	3913174	25	0x738cf70fae7989e44eb27795afa79ea7ae1bafcd913fde945a8bef42db3540f9
419	0x0000000000000000000000000000000000000000	0xcf0489ae7bbf3b7321841f3ce9db682a6b0cf612	957.36	15437906.426066176307639589	3913174	26	0x7e6c0e7a405b3a007d142918c4ad4da5ca955310890a1a73585f8bb6b3eecd4b
420	0x0000000000000000000000000000000000000000	0x81e46659783cbedfd4cd59067ce13939a0172aad	526.548	15438432.974066176307639589	3913174	28	0x9f9397a545056566c382dae07c9825281045f7b9aaf3185a636e0d35e79228b2
421	0x0000000000000000000000000000000000000000	0x4ef2516c2c452f67ddd07ffb35a5e8699144694a	23.934	15438456.908066176307639589	3913174	29	0xbb5661864a0861ba284b34cde5a08a8abfd46433dd9dea99cf0d7597b8d1f3aa
422	0x0000000000000000000000000000000000000000	0x76c8af9f43e36de02a76d6f2e4ec9dea7ff74bb4	239.34	15438696.248066176307639589	3913174	30	0xcc4585158720f058b173d1f2860aec36d526bcbf75c970367de4ae6395122f8d
423	0x0000000000000000000000000000000000000000	0xbffd8aaa29274a7460c0952e1e3d3474033d371e	153.1776	15438849.425666176307639589	3913174	31	0xcfe99926aaacd097d8c2ed47a2b3d7e9de2950c3b431aa81925f17fa92406c1c
424	0x0000000000000000000000000000000000000000	0xdb3b515d7fd7c0a4acb5408c39695e0e507aa633	1913.140356	15440762.566022176307639589	3913174	35	0x5f5d0c04e4a29eabea738f8d0ca602362359857cad1c253f2d27e5deded2e7f7
425	0x0000000000000000000000000000000000000000	0x5c2f2adf56544bb8cc08798b9262d3fef5b6c03d	2867.2932	15443629.859222176307639589	3913174	40	0x3c496bea0447f1385a38268812caad98d3250e9bc8f92d09eddde1ddfe7ea111
426	0x0000000000000000000000000000000000000000	0xa9319ae01d54f2f899d6236ebe9c46c5751f5593	239.34	15443869.199222176307639589	3913174	45	0x52b22a5d7100a995af85b0e0cbcad6c3c78e7bdf46f51d2b7375e1b8ba801b00
427	0x0000000000000000000000000000000000000000	0x2c074e48db34b16324c4c5de81987a0dee6005f8	478.68	15444347.879222176307639589	3913174	47	0x8ed8c2e312bf7743cf8c63115035c1eb605a52fe9e4c3173b8c7fc5c7305d6bf
428	0x0000000000000000000000000000000000000000	0x9835b37eeeaa5856588486490cacecad2f723e2e	2393.4	15446741.279222176307639589	3913174	48	0x974e5060cc0289433c6c873febd20b4f149b28594acdd5f38267f4ac4b26442f
429	0x0000000000000000000000000000000000000000	0xc233df4078bf948e86dda465d1c196bd251ae1a7	957.36	15447698.639222176307639589	3913174	52	0xbd6e1ccf53bd7b783f3ba4a9111c0dfa43cf558d7e5db713c613cc02d155cbf7
430	0x0000000000000000000000000000000000000000	0x05c2deab3e3486b18ee8a1e5787073154340e22b	4786.8	15452485.439222176307639589	3913174	54	0xf147afeb37d9723d09b1fe7646a4dddac91a641b23387d1a43506ec83c28cc51
431	0x0000000000000000000000000000000000000000	0x0ec7d13e38d9db4c387ec7a57b14895c44ef5a49	47.868	15452533.307222176307639589	3913174	56	0xfa3d553093d2d6c5b8dc54d678dd8e9db83b6a166d55d715a90187aec8308b90
432	0x0000000000000000000000000000000000000000	0x86834a65e12fc6fa4b564b8d0f6b98a4caf88f50	2872.08	15455405.387222176307639589	3913175	0	0x4b21461dec68c67a8d277221847799d71c608ed6dab9d19b2042bab7400dbb95
433	0x0000000000000000000000000000000000000000	0xc83e088cc83ce77f5d181da109b620af59395187	494.34526923432	15455899.732491410627639589	3913175	2	0x0f07e8d66d2ea24c5fb49c7dd64f60c3d9f7ba9f437f207fcec7b7a67732176e
434	0x0000000000000000000000000000000000000000	0x3da0145d3953cef2548b14681b10f9304c07b32f	478.68	15456378.412491410627639589	3913175	4	0xd8bf14e33b9d725ce2aa420021adfcdaf42c1eb2968f16aef6fe7d3e80fe155d
435	0x0000000000000000000000000000000000000000	0xd04fdf4b3368a8cfe8a5ec6dd683a2c7653826ad	1335.5172	15457713.929691410627639589	3913175	5	0x761cf6c3c14c2ed178463a2800f410817436fddf13e3c60f111fe8932e0e2e9a
436	0x0000000000000000000000000000000000000000	0x191d9d4ad88614e1c2b354928a25702305698762	1053.096	15458767.025691410627639589	3913175	22	0x370dbea8d31f66b8c10b2510b2228b056b1545762ec418c080a30bc8113859a6
437	0x0000000000000000000000000000000000000000	0x3aa5b1e7e608ab5f79001f773249357573e76af7	23.934	15458790.959691410627639589	3913175	26	0x3a84747256d115e23f6d4da361dcec91be9da9f29626b1abe1b3ad591dbc1abe
438	0x0000000000000000000000000000000000000000	0x989943f1df0874e5735b6ec2fa4d221384cbb067	2393.4	15461184.359691410627639589	3913175	27	0x3d1ce93bd4c4bf2578f594e18181f543011fb2ef2a96f4c794f2e76d2b4e78e9
439	0x0000000000000000000000000000000000000000	0xe865cc99b573cdd25674735bcd141aa16e3aea4b	134.0304	15461318.390091410627639589	3913175	29	0xb74f7695c10e3ed501350f79c68674193d728d997ed2750e8a0e52bacd4f08d3
440	0x0000000000000000000000000000000000000000	0x73ee4563975da34128b5489d828a6a6c21f1857b	2393.4	15463711.790091410627639589	3913175	34	0x231ef5729aa8fe15219ce6268e41142a86cabbc545baba2cf940431f61384f1e
441	0x0000000000000000000000000000000000000000	0xb819ba59e00184a6d6cb657106056251e10a8eeb	9.5736	15463721.363691410627639589	3913175	35	0x29c63b2c28e670ff90137cf16bb139bd86483106dc3c31b76f6dfb772bc1951d
442	0x0000000000000000000000000000000000000000	0x88e83fb1be974f5cf5ce9688065f07e7e4e88a1f	191.472	15463912.835691410627639589	3913175	39	0x491a15f3dc7b8df0d357c346eec937737407d934a039fa7e3d5fb123fcfefb21
443	0x0000000000000000000000000000000000000000	0x0fb7c30560d9468661d3b2db733396f22db2d813	957.36	15464870.195691410627639589	3913175	42	0x831ed0f8f78b714accc2165b8596fdd33f3702eedfd3c00a1abd2abb0b016831
444	0x0000000000000000000000000000000000000000	0x901b245b7597da3c057bb6bc363cd927949a5366	1436.04	15466306.235691410627639589	3913175	43	0x8a6f01fdc40b85be1ddca3ccb871b83c74a912aa68a17ca061805d2f68116287
445	0x0000000000000000000000000000000000000000	0x06245d33485ba1cadcff93f9c8b02f38bca8d4cf	478.68	15466784.915691410627639589	3913175	44	0xd6db138564f8ae3edaca44ad34fd113554d488709b5f844167fc1db7ad891ff2
446	0x0000000000000000000000000000000000000000	0x3ebb855b53b5056ae43c7600613f4986685c4662	1436.04	15468220.955691410627639589	3913175	45	0xe8642bf504e0383a5ac4f2807e83fe66e38075249a6b744929fb1915b3e9c156
447	0x0000000000000000000000000000000000000000	0x532cbc68f66bb7482086a15972fa20ee3aca21c4	124.93548	15468345.891171410627639589	3913175	46	0xeae0d9b1a1e8a8ebef84983478780dc8d505a644cdb1666e68becc3d6f18c6fc
448	0x0000000000000000000000000000000000000000	0x17cd8a199ba8914bf8bcbd6d04ecf5ed4cd4985f	957.36	15469303.251171410627639589	3913175	56	0x122712395cb9a1c5567329fc8b609ae05858785ff4052b78d1c0958308aa0cf6
449	0x0000000000000000000000000000000000000000	0xffbb70f54e8864dad9702c350c505e04cdfb078e	2872.08	15472175.331171410627639589	3913175	57	0xaa08d9d3e3344ab8a3c82f60b9730ae599a9a018412f29f2a34aa1fa6ff0eba4
450	0x0000000000000000000000000000000000000000	0x40c04ed72c791bfb5692de2aeda86445086bdc75	718.02	15472893.351171410627639589	3913176	32	0xdb5505353a1e5eef77a602526e187c9526d33069bd27e17d50f404db7cd418e5
451	0x0000000000000000000000000000000000000000	0x7e4dd691fb6b6bf83baacda9347d19f308249b75	9334.26	15482227.611171410627639589	3913176	33	0x7d14c403476d7eacfcd69ff507ce1478bc1539a3df5477632e8539cc39475b40
452	0x0000000000000000000000000000000000000000	0x4882a469a8c72427e0f2630ee478dc3c01fc6860	2393.4	15484621.011171410627639589	3913176	34	0x59f424088f1bcfcad22228f6d2f5c8c5593cb88431a7509d24814b5746ee5cdd
453	0x0000000000000000000000000000000000000000	0x04c7e7e9365ccc3821794483e0152f727675eb13	957.36	15485578.371171410627639589	3913176	35	0x499bf608114797265989a1694e9a23ca0d83a21b4e3eaadfcf3c840bb688bacf
454	0x0000000000000000000000000000000000000000	0x8c5645a50f39b5d1a6112000748b3581e8be7ad2	143.604	15485721.975171410627639589	3913176	39	0x7e553a75cd6382d26d9638ee968f23e82340044983aac88fecdb4551a3e61ece
455	0x0000000000000000000000000000000000000000	0xf9377802421bf61a74b5cedce9beb3df78b46383	478.68	15486200.655171410627639589	3913176	40	0x5ff54994e85968490b0fd524befaf8bd281df1c40fae7ce5faea9182c042eb4a
456	0x0000000000000000000000000000000000000000	0x54640f357199a4e9e1b12e249a7df9b52beefd1a	1909.9332	15488110.588371410627639589	3913177	0	0xdcf5f963294aac19cb5f905476b4e33f5296e97e55682b7b346f758c60d350f7
457	0x0000000000000000000000000000000000000000	0x90b05a83c6ca34bcb20799411460180ebbb6212f	2393.4	15490503.988371410627639589	3913177	2	0x9efe9c4b83cda6c9fdc665a3b176c30837ec441538b8504f9efdca0a7c8ceb92
458	0x0000000000000000000000000000000000000000	0x95c891f82bed97e307e333820b899e02a992ce99	957.36	15491461.348371410627639589	3913177	4	0xb225411a2ad7e35db3ddc817636b9104f87c8cc117cad65f773f57d8ab6e8bd9
459	0x0000000000000000000000000000000000000000	0x8186fea9809f0d6f62d69dfd5f03bf21a02cbfe1	478.68	15491940.028371410627639589	3913177	5	0x1b46098a8f45b527979b8a8fa3182a1488742c058076a7167a96a21b84b65e78
460	0x0000000000000000000000000000000000000000	0x2caf0d45deead80da1e7d091c955d48b58a28a08	65.57916	15492005.607531410627639589	3913177	6	0x2633323d231e08323bfa815e8e9949dff4ff3a53d20652d60c3218fa9cb340b6
461	0x0000000000000000000000000000000000000000	0x08fdaa7c80b888a84a2f0afd7b3f7c9f186e1306	244.1268	15492249.734331410627639589	3913177	9	0x40975904a8ffc2fbc405e3a46a13e2bc54407edcc699498552208f277b4cd99e
462	0x0000000000000000000000000000000000000000	0x7a82fb208303aab2369105ba03c9c0146ac8fd86	957.36	15493207.094331410627639589	3913177	11	0x6769eb2d07416637379590813e3120bb187192a14b23de6f88c8fb7e8cd1577c
463	0x0000000000000000000000000000000000000000	0x7d77f07a0ecfde4de6cdf8f9f446cd31591e486f	359.01	15493566.104331410627639589	3913177	13	0xd060c402f7840d66554c3d53377bb8da21aa9d7c8ff95ed09b151f1871ec7d42
464	0x0000000000000000000000000000000000000000	0xac3df2f519d815c72dae9325b134142f21cb41f1	478.68	15494044.784331410627639589	3913179	3	0xf3ebf33c81557bffcaf632fadcf23d796416c1ea45dae08587fac439e4d36fba
465	0x0000000000000000000000000000000000000000	0x8186fea9809f0d6f62d69dfd5f03bf21a02cbfe1	957.36	15495002.144331410627639589	3913179	7	0x03b58fc0204a1a221a1e3111f1c1555b4a4f91ee7723cf3b533999eaf12fe402
466	0x0000000000000000000000000000000000000000	0x1fddcdce7c77882da98635abd727280916149827	2379.0396	15497381.183931410627639589	3913179	8	0x28f56313dedce64b97a350e32ffbe7d39a179372e9dca83267155640d918cb6a
467	0x0000000000000000000000000000000000000000	0x0c6e3c30fa208da924f890d9beb42c5095c0ca73	239.34	15497620.523931410627639589	3913179	10	0x53582ba3b0363a2abadeebfa3c5c4a7ab718953a287cbcca102e9505eeb02e08
468	0x0000000000000000000000000000000000000000	0x4000c5c6c7715762ed42381911cd611ce3994362	4.7868	15497625.310731410627639589	3913179	12	0xe22a16f51ddf3bcf25e121102fbac996f6f44d844b348c20c6dd39f73979fca5
469	0x0000000000000000000000000000000000000000	0xcbfb25027bc84571222569a18a78528bf8e1959b	23934	15521559.310731410627639589	3913179	15	0xef16f6a32417cd0de06901ec88c163772bc3736e6f79632f3d50e9e0fa3991df
470	0x0000000000000000000000000000000000000000	0xc379f722a19c6eb5cd18acc820646e11b51ab2f0	478.68	15522037.990731410627639589	3913179	16	0x186da48ef262aa927284c6c79b7a23b4a12b012616dd067d634c666a5adf8aca
471	0x0000000000000000000000000000000000000000	0x5b4e516df9c2f148fe0dedb78df8d926aef78da1	957.36	15522995.350731410627639589	3913179	20	0x7b842f3e29acba7844fbd49d36c88ac7e2b07f9e1b47123695f1c3e62f0fcf55
472	0x0000000000000000000000000000000000000000	0x8805acb153a64fb6d42a9526e968af473965ef1c	957.36	15523952.710731410627639589	3913179	22	0xbc6dc8ce31357f2f4e2f82411a0b9c3f13e5a6ec35bfc1ca1678a8f0e0af05d7
473	0x0000000000000000000000000000000000000000	0xd58d0889fdebf8a3860f6776b0777733f229c2a7	47.868	15524000.578731410627639589	3913179	27	0xfe11035e83b871397962ab26ec07bbdb89c3181f8b634e22efbd9628e404556d
474	0x0000000000000000000000000000000000000000	0x56488eba3e445b71eed85b081fabc01db3f65ec8	23.934	15524024.512731410627639589	3913179	28	0x7d537290f3c96473d8c8a69cd887844558d7bced9f909ab4c848a6d1b99959c5
475	0x0000000000000000000000000000000000000000	0x928e15dee85484c0bcf2a88c3030277fbcf3a761	533.24952	15524557.762251410627639589	3913179	30	0xe51cb4dcd28e1bc2ae65f49092472aa648197e6854ed99c3556ad153c54e63d5
476	0x0000000000000000000000000000000000000000	0xe5c39129de34cd8c78b3bbfd41454fc91a96e980	2393.4	15526951.162251410627639589	3913179	33	0x4ff342a3b87fbdfbff612140d3faf0f4accf5a4c930723f58d5fa9d9e921acfa
477	0x0000000000000000000000000000000000000000	0x23765527ac9d58408168c97980dd30d0fc9627b5	52.6548	15527003.817051410627639589	3913179	34	0x9b6b91b84be4c282d1f5dc958cf03c88b6f660998bfec0accf9913367423dd09
478	0x0000000000000000000000000000000000000000	0xc4b1abec2c76f6c86c66796934aaf5119660e723	239.34	15527243.157051410627639589	3913179	36	0xf788f9d5981d03fb0d551b90c976dacd2f1585ab95a64e3359fa34bc4c5f6985
479	0x0000000000000000000000000000000000000000	0x482f990559f0f685ad4f893a8fb58873b283d658	191.472	15527434.629051410627639589	3913179	53	0x1f222afcaf4c89c5f7245a4bf75fa4dd9a9492ae2692b24ea757cb9af0656b48
480	0x0000000000000000000000000000000000000000	0xe02c45b69816b5b3307a023d98db8692bee78838	0.670152	15527435.299203410627639589	3913179	55	0xe41a740efb62a592786814c46cbfeed29cff8240186fdabd95c291a2c24d18a2
481	0x0000000000000000000000000000000000000000	0x101f64fdd3c10c832e9384ec46a8da1e69a5e519	478.68	15527913.979203410627639589	3913179	56	0xe9634b2b81e1d28bc8b10bd858d8b1c086a7a6c8fb048f4f8dab305160a2960a
482	0x0000000000000000000000000000000000000000	0x3a2be3642a8c64b4b2884857dcfd7668c411ff40	23.934	15527937.913203410627639589	3913179	58	0x65bd8fcb8fcf3bb68803730c1d474ecc8f7341008c49094fa380fbc0e69ff239
483	0x0000000000000000000000000000000000000000	0x2e5d4bafaa4d2a5476ee423adbc7f5863e452f12	124.4568	15528062.370003410627639589	3913179	60	0xd1683ba3a8591f14243f5c0ca2fdbe19b3f43dd62832a73509135753dba7a35f
484	0x0000000000000000000000000000000000000000	0x28a04f51ddeec007ed99579fd930c98c02cc0ad9	19.1472	15528081.517203410627639589	3913179	61	0xd2aa079b4ded2537d534352d2cd069dc7305def27109af033f0f7dc390e53b2c
485	0x0000000000000000000000000000000000000000	0x9df668b00d9a4f875c2e38c15c67913bebdb242e	957.36	15529038.877203410627639589	3913179	63	0x2743fee4df70a1c5ec7d11441ec70d413f4165c61905a70e387fedeaecc55847
486	0x0000000000000000000000000000000000000000	0x03b963429b6bff571a723672e4e5318e6f84403b	957.36	15529996.237203410627639589	3913179	64	0x47f80d77e17c4a0a317bf8e1171a2e3f519f1cc61262bc4146ddb569823ee562
487	0x0000000000000000000000000000000000000000	0x79b9ed7147c0ea3c3109f303d5d9be92e472604d	957.36	15530953.597203410627639589	3913179	65	0x5af11c28e1c6189327a369f51965941bac85dbdf0901e8581bb189ed98d1e275
488	0x0000000000000000000000000000000000000000	0xbc3ff3426fb90932bad89364b0000aaf735fcf79	3829.44	15534783.037203410627639589	3913179	66	0x8c94218a3c6e1fe0401373659a27192a1c763454c79fb9e27323ff0122ebc58d
489	0x0000000000000000000000000000000000000000	0x81334fbd096c9f293610ef7850aac20632dd5c8d	2393.4	15537176.437203410627639589	3913179	68	0x02bdd416db3156fc6ee57942a4b895a989b87fae780353e1a27c4e25cfffc593
490	0x0000000000000000000000000000000000000000	0x487088b1e36dc17f5e3c7739b08e8d3c3dac7ff1	47.868	15537224.305203410627639589	3913179	69	0x4505657a06283785f41bd902daa234c11975421d068a490a6b6722bc7731b3da
491	0x0000000000000000000000000000000000000000	0xa16840bc08c6d03925939b36d40cb48fe982d028	765.888	15537990.193203410627639589	3913179	72	0xa81ed37f0e5c9c15ca3be50344042c38b8ab300adfb19ee5903a1c767ac59788
492	0x0000000000000000000000000000000000000000	0xdc1f117c8a715873028ce2c4628f528b20ccc9b5	2393.4	15540383.593203410627639589	3913180	9	0x5e97ad5be4722a55f25187d879db5eaeed8b8408c8899d7a7c84bf0891d2efac
493	0x0000000000000000000000000000000000000000	0x78bf0dfd367a27998a90aa0637b189015c0f9617	536.1216	15540919.714803410627639589	3913180	10	0x7b5af9a0ba20aa9a8752b6290b75c80f76248def4819beb35c7bc043a9ff7bd2
494	0x0000000000000000000000000000000000000000	0x488c0bad304247908afab3053293bdde533846f4	143.604	15541063.318803410627639589	3913180	22	0x0b4d0b260864bb5dac3f8aa81e31757c832e0e36468db261b04824774ca9ca62
495	0x0000000000000000000000000000000000000000	0x4ba307d943446c0335e07ac2a90119515f696d43	603.1368	15541666.455603410627639589	3913180	24	0x5cb213a70c21cac45ba7d216f4df139ff9cb5e9e107765a29be6a0a668c377ef
496	0x0000000000000000000000000000000000000000	0xce2a81590a6a8d3a37d94028e0b8e766c4d7e06b	1436.04	15543102.495603410627639589	3913180	26	0xf2017a50dcfec13744e1ab359d23e9bbc125c95de46c2dad11559f870db7989c
497	0x0000000000000000000000000000000000000000	0xf06498ba539493a371e1b4a133861cde7c0e1777	957.36	15544059.855603410627639589	3913180	35	0xe14bc66057f520f09d2d27cf76f6799939bce8f92072aecaf0a1de5f873550d9
498	0x0000000000000000000000000000000000000000	0xeb816ddefc8413bf1aa74f1cd07a9db5291167cb	9573.6	15553633.455603410627639589	3913181	1	0x6e9e1b5954ba6a3585f37d22b8072f3af9ecb6aa3c02afec8cadcd37da20a473
499	0x0000000000000000000000000000000000000000	0x0d02a58d35e508be48e61845f925e4665806c66e	4308.12	15557941.575603410627639589	3913181	2	0x79f373c9e362366e8deb5ee72e65ef5912cfa7f3571d835c36f1065a674f0b23
500	0x0000000000000000000000000000000000000000	0xea8c8d88486e979153690b0adddb9d856c96198e	708.4464	15558650.022003410627639589	3913181	3	0x7ec35369063c29a6bc7bdf6c829905f2204ac118dc4182b5e3b7d3d6233e5ba7
501	0x0000000000000000000000000000000000000000	0x4ad9178b47868752beb5aac9685388cac1f1cb7a	47.868	15558697.890003410627639589	3913181	5	0x910617487c5a244c66d27fa93488dfa0e3921216e52ffb412bc127488c374310
502	0x0000000000000000000000000000000000000000	0xdf4df1c92e6b54e1d4bcb58c62a16da554537843	33.4044348864	15558731.294438297027639589	3913181	6	0xcb33da584e8b94319e9fff92200e59cf67aea824ac33cfcaa72fc182f82da39b
503	0x0000000000000000000000000000000000000000	0xf5eaff9615c133738ed7ef003e848dbd6e433c35	957.36	15559688.654438297027639589	3913181	14	0x9afcdc4eac9706f7ec63fba2c58e3281ddf07472d61d52ab77f877102ecea153
504	0x0000000000000000000000000000000000000000	0x94e2c45be73cf6ad58f4b63d0c4b2f8f55cf7141	957.36	15560646.014438297027639589	3913181	15	0xa2d5a8113b7ef825d52c43028c477e331d27b2f5474718bb00aeb575fa9b392b
505	0x0000000000000000000000000000000000000000	0x406a4c8a1f5c5db522a1292901d6d52feaaef599	478.68	15561124.694438297027639589	3913181	30	0x15d136594ef0038915e45d7e776bd121d4662629693fef04ae59de05a26fd84c
506	0x0000000000000000000000000000000000000000	0x0fd20d0c6e8e69f1680850106a9dbbc5f5573ae6	23.934	15561148.628438297027639589	3913181	31	0x6bdc19bf158d013a4f72e807d3e9d511c5bb6441634f016411a10090a4a5d1d8
507	0x0000000000000000000000000000000000000000	0xec20c636b2d1d65be7306d8cd22664de7fbbe97d	239.34	15561387.968438297027639589	3913181	50	0xa2dc752220020157c4200cf81bda56e2be5a01a58751ee16e77080c483bd171e
508	0x0000000000000000000000000000000000000000	0x15d655abff6ae7f109ebf5c2259ea3ed7de97619	329.8260771	15561717.794515397027639589	3913181	56	0xbbaed694d6a423bcf5661b6de24df40b1e5f37267e1951004d278fddbe0b06eb
509	0x0000000000000000000000000000000000000000	0x0fc73d5df9256ec376f31d82f5460e48f314b918	957.36	15562675.154515397027639589	3913182	0	0x6759e4304cc87d181ec7e8d4de78ea35ec0fb3014df29cb95335c0baf6f307cd
510	0x0000000000000000000000000000000000000000	0x14dcae28535c4ede02d0b7ec4d5257f7326e0bf9	909.492	15563584.646515397027639589	3913182	21	0x8a037cc1aa781f2516c1b5334cddac54590f6cd78da6b2d54c319d1b2eefa3a4
511	0x0000000000000000000000000000000000000000	0x709a416befb3ba258f5cbde8bcece99abacd9bf6	861.624	15564446.270515397027639589	3913182	22	0x6ba37c355329224eda6a0a2b05e3cfc3af67d2e108cb4790b8747c9b7cf146fd
512	0x0000000000000000000000000000000000000000	0x747fb60139ec4e3f71c8b8a449aef3a676689dd9	1914.72	15566360.990515397027639589	3913182	23	0x0782a57f5aa80f48983829e3426df89640b8a1765fd1c943ae3f4a1fd8333437
513	0x0000000000000000000000000000000000000000	0x090cbb66effceb8dd538d8a887291197ab778579	167.538	15566528.528515397027639589	3913184	0	0x0c04ae966341c9bd5f1bf974602d9d51fdaf2c2e7d2bb8d7e2fd44012dee4796
514	0x0000000000000000000000000000000000000000	0xc37bf0eee05056c4c190300aeb942c62cf3d5772	4786.8	15571315.328515397027639589	3913184	1	0x096709f99ac6576e769e9abb1788aa56309877c5ab2e0c126c72e6b2f9e24a6d
515	0x0000000000000000000000000000000000000000	0x75aa91d048b051a155f71e6d42a3c6b8ec5764eb	516.9744	15571832.302915397027639589	3913184	2	0x9d0aef9e1b776eff537c835103cf6b4aa8f9deb71fb6f7414c03b4736c4fd514
516	0x0000000000000000000000000000000000000000	0x644a89a81507347ec7ec5d396a0f1615e76cf3a4	38.2944	15571870.597315397027639589	3913184	3	0x2b625afefec591664ba853862136f3f5019c6c4a19edfbc9dbf8da09c69f7e21
517	0x0000000000000000000000000000000000000000	0xceceb9d581b900f37d23d6239802db9d02760691	478.68	15572349.277315397027639589	3913184	5	0x33bc0968dd3e0764c3d764bab1718960695c0ee980b631a9e0aa70be5b30afa8
518	0x0000000000000000000000000000000000000000	0x78c875d7dff83ef985c94bfbdb3e43dedbf0ae11	95.736	15572445.013315397027639589	3913184	7	0xa096ae4ddb9cfb89e8ad77bf02a6671c6b73d4f540186d0d8c7e79c52189c168
519	0x0000000000000000000000000000000000000000	0x77057b6231df721b66a6681c3cd41567045a9558	598.35	15573043.363315397027639589	3913184	9	0x5b26c8608e593d9fb0f4a6bc4b3bc73763ba0b68d34ce98dbe9c724c53bf7850
520	0x0000000000000000000000000000000000000000	0x8d629c20608135491b5013f1002586a0383130e5	7180.2	15580223.563315397027639589	3913184	13	0x846b26e178c316666f78052fd99fce9d3537dc61c291e43c0a1beee9a999bfeb
521	0x0000000000000000000000000000000000000000	0x372570959c98c48cebfd4fb65a414b938604df67	478.68	15580702.243315397027639589	3913184	14	0xbdb95169a3ac92c9919d6f103f2fa21ff506992c113441f46d22c7bccd7f6ed4
522	0x0000000000000000000000000000000000000000	0xe3e5c16af0116d6291ed52351aea6d4d76340718	2249.796	15582952.039315397027639589	3913184	20	0x38a2cc58ac97332ae4f3b0b3c519f040f639884cfc2e0ea8861b9a83e053c77e
523	0x0000000000000000000000000000000000000000	0x0eb0bf09b5b29cb79cc2efab7457f92ee2850727	478.68	15583430.719315397027639589	3913184	29	0xcf8ad901f5adbc111e1d63f5cf9459452ecdcdbaef79fa5854cde8d171fe0a81
524	0x0000000000000000000000000000000000000000	0x00e96c34d0d80fc23d730ac0702c86ac746f5534	1148.832	15584579.551315397027639589	3913184	75	0x4177f11c4fb7ec1db8c09230aaaac246dc685d102b24b91e6a16fb1e677e7b31
525	0x0000000000000000000000000000000000000000	0x0f00b1bb94d807959499e4ec372d3f9102d825cf	4786.8	15589366.351315397027639589	3913184	76	0x45f84fe5fd4429082918dc79f6f20992a360d72bad14ab11c151f8dd8ad29cdd
526	0x0000000000000000000000000000000000000000	0x4f48e1b03e95b6ca0a2e03bda03211e76ec1c4d5	957.36	15590323.711315397027639589	3913184	79	0x733799275e04981e78ab2cca21e46e32238a360d398433c89e2ab5769a3f8f0f
527	0x0000000000000000000000000000000000000000	0x9bed192bff95556cd18c39c8707dd9d0524c9ced	44.6701136382	15590368.381429035227639589	3913184	83	0xac0aeb3f86f6d0d8a9b6fca3e97a390b9f1b80f0818de434662230e3c1c889ae
528	0x0000000000000000000000000000000000000000	0x901b245b7597da3c057bb6bc363cd927949a5366	957.36	15591325.741429035227639589	3913184	84	0xd2d991968631833c58677196331a3d55b794f7533a140357dec6f6d1e24345ee
529	0x0000000000000000000000000000000000000000	0x9e6b12ffda3d7f641439fbd491825fdd8009b7f3	957.36	15592283.101429035227639589	3913184	86	0xe33625cf1afa57fa308f2d6ba688d99ef54ea8a1ac883f90d273c4132630aecc
530	0x0000000000000000000000000000000000000000	0x1a72ee1c0c32c98736552917c581a67db9670e9d	478.68	15592761.781429035227639589	3913185	0	0x4fb5158a9d599ae5ef5d5cc844cfcf496713b90d35653acf65e8236d327fb476
531	0x0000000000000000000000000000000000000000	0x7ab9180bb2d881209fb51fd01b9d3dce39085bfc	1005.228	15593767.009429035227639589	3913185	1	0x065f4e7155625d967491861f9df8b98aeec638b1ac045f61ae0244cdbd98ebd6
532	0x0000000000000000000000000000000000000000	0x9e2198b574465abc784e992b7a24ad110df36740	148.3908	15593915.400229035227639589	3913186	7	0x6b71344b5f3c3fe43b499cfff5b27f2e14e7ebfac194e0fb26e66d9f2e5f82b5
533	0x0000000000000000000000000000000000000000	0x5c16b60f66dae26abd233b2194e9ad38e78d50b3	765.888	15594681.288229035227639589	3913186	11	0x4edbcd77f97cd44411355105ccdd33a2abcfdf4f30138b3b5e40b8c0e9211301
534	0x0000000000000000000000000000000000000000	0xfca3f87361c089e55835e3535ef90c4077e3385b	181.8984	15594863.186629035227639589	3913186	13	0xc5737f15157681ac6e01281acb8ccf4cf013d25e152457e92585f8ab340b3a0f
535	0x0000000000000000000000000000000000000000	0x1d9643358cc78a3a8a08b084e2e8262bd4848ced	11.7836272656	15594874.970256300827639589	3913186	15	0x872eb8c2c2e50814ff40d7b82fcd0300339b42d00152732d40e604647e4d9631
536	0x0000000000000000000000000000000000000000	0xf8546916e0850e96caab91a2b58aad1c06542e5e	9525.732	15604400.702256300827639589	3913186	26	0x0ad809ec5a041742dd06ab9151e99c19525ee0b8e2b00ad4a6a14cac658695b9
537	0x0000000000000000000000000000000000000000	0x5d682c7a14f0821c7bf1bd0349210167d394034c	478.68	15604879.382256300827639589	3913186	27	0x034d7f1058f556a2687cdf8fd48d9f05524993fb7b1a1463b4c3d0a84f34aa11
538	0x0000000000000000000000000000000000000000	0x9c945ca559edc6adba2bee5a97723e01fa47bc3e	43.0812	15604922.463456300827639589	3913186	38	0xf848bcb1212d68cda3400d4cdfaee99af1ce203661d6c1dd26d6990b349fe710
539	0x0000000000000000000000000000000000000000	0x0c44d2e73c857f6f59f62304e6a61a6788f2bcd9	396.6007404	15605319.064196700827639589	3913186	41	0x54cbaa4588e323d0f0dc2ac1f2e2ee3283ac59ef805ba2faa1b7a3c675856ded
540	0x0000000000000000000000000000000000000000	0xd3b3acde8c2e0a76a30e3c556bb234d068d6ec87	2393.4	15607712.464196700827639589	3913186	57	0xaded44f6ec19c3570829322c06b2a25dc93d63534247cd41de66e15c5db61614
541	0x0000000000000000000000000000000000000000	0xee2b81c385ed1dfbc95121d893aa6fbb4b1f6667	1914.72	15609627.184196700827639589	3913187	0	0x932b8adf38fdb3920db0822a4839da1db43b5530e3d564f519be6805e877befd
542	0x0000000000000000000000000000000000000000	0x36525cb405fce129a2259c4d332a5e8ca6df998e	239.34	15609866.524196700827639589	3913188	15	0x64da445606e5de1545f082898859cbb9950f8c2579cc750761a2f553ec939e07
543	0x0000000000000000000000000000000000000000	0x750fc69ffa68021a4fb94493aebb569641c439cc	7658.88	15617525.404196700827639589	3913188	16	0x4c422ca09c4450f01c1ab3fa70b65e38e18a36ef6e9472a9273a23d0746762d1
544	0x0000000000000000000000000000000000000000	0x40d1cb3e3f5224075970de8b9ed1d252497ee448	0.382944	15617525.787140700827639589	3913188	22	0xd36589b4a639977da1cccbd22a858ef2f1a32e456bb13eb10e62803b6a608cc4
545	0x0000000000000000000000000000000000000000	0x0d5648706ed6bb95f9d46c84530fc1c1be6d4945	478.68	15618004.467140700827639589	3913189	13	0x27dc51fcca28b4327285cd2b8fe515e25750baa37a5ca3756e12ad52032ffcf9
546	0x0000000000000000000000000000000000000000	0x103fcfe743b40dc36b3fb2b561afc695f925b640	52.6548	15618057.121940700827639589	3913189	14	0x2960d2f04e0b8fb7203d0e758aaaeeaf50627fdfc4dff0c588ff2802eeb1e8a9
547	0x0000000000000000000000000000000000000000	0x2a3d9cbcc22e1eae40144f786737a01a1f4fc40f	239.34	15618296.461940700827639589	3913189	15	0xe66e14e48b95a3e7f9be892f1cbed5fb91681d91677bf20dbd8b36e30f40fe09
548	0x0000000000000000000000000000000000000000	0x7519c7ac335731f4679be27cdcb8e4b3e2b253d7	28.7208	15618325.182740700827639589	3913189	17	0x5a7932d913d77ed182d663e4985b548fb1e78d72973359eb14dfaf0293d4f1ff
549	0x0000000000000000000000000000000000000000	0x2c68f349cc8b10c73f0362624099f583f6644b2a	454.746	15618779.928740700827639589	3913189	18	0x8fbe52a068aca0750d1c5e37a08ee3ca38fa7b713a465ac79fe770b583c692f1
550	0x0000000000000000000000000000000000000000	0x8b455df0dc3effa6c9add3f33b9d4ca818939698	95.736	15618875.664740700827639589	3913189	19	0xb8d2db47e253d608c73ae454a73e00c8af27bd08536d5ad754653dc46a6e42d6
551	0x0000000000000000000000000000000000000000	0xdd9da16f27e420e62c8c1fc3b98e0122fc5f6520	143.604	15619019.268740700827639589	3913189	22	0x5309a810a1b519c3dd6bf5403684e26640ba38aed1842d4beb26f8df133f2f98
552	0x0000000000000000000000000000000000000000	0xb9983ef57f2c275ee544777ce816ae9aabb42f48	1905.1464	15620924.415140700827639589	3913189	45	0x2150c73b07b11eb5fd70818a35e9ac8784ba08e3b830c4b544577583e1e86c25
553	0x0000000000000000000000000000000000000000	0xdadd761ed259b4674a4728be71460cc86c78080a	2872.08	15623796.495140700827639589	3913189	51	0xdc46be69e38d01660293e67432ea75eab7af8eee11ee712af163dbbc31eaa535
554	0x0000000000000000000000000000000000000000	0x431c75744e4514885712f80e92de945cc047d892	31592.88	15655389.375140700827639589	3913192	0	0x31950e4ce314555a1f0c9f0538f470b657426246e590304aeafeb9b25cc5cc2f
555	0x0000000000000000000000000000000000000000	0xef58321032cf693fa7e39f31e45cbc32f2092cb3	47868	15703257.375140700827639589	3913192	1	0xf13c66e2aa5042d5adde28511bcf335581d7c87fcbd0362df95b9d9cc4c815a0
556	0x0000000000000000000000000000000000000000	0x50aa9ae1d10b553e4d7bc80375309af26e6d9ef4	4786.8	15708044.175140700827639589	3913192	2	0xa4cb84efed0f55e5ff26c3055789b5f21056c1efa6fdae7e8b8619e6f382b014
557	0x0000000000000000000000000000000000000000	0x44de6d5f7c661d2fa8af70d26683d0a08d203bc3	191.472	15708235.647140700827639589	3913192	4	0xc4c2230dadf10709575c9d99b85c087b5248b59291350f53c800e327cea08b1b
558	0x0000000000000000000000000000000000000000	0x1d7c515ce83a6896d2464bbffd1b4b1da12bba22	47.868	15708283.515140700827639589	3913192	31	0xb5cad9f174b45965d6439fcbe95c8f0a13cb7d65e122b671c22667945b146149
559	0x0000000000000000000000000000000000000000	0x6ec01f082d014573ff73778671488557ce63440d	354.4114361232	15708637.926576824027639589	3913192	32	0xb0c4646cb400e5b68183d675e468699a46a38bb314192615b6126cb03e048cda
560	0x0000000000000000000000000000000000000000	0xca59e9d4e0f590620e4c85ec2d813bb27de980aa	71.802	15708709.728576824027639589	3913192	33	0x9e65dcfc0db123694e00e11fa51421538306e1170509a86477956bb6ad17b854
561	0x0000000000000000000000000000000000000000	0x86707ad732036b2e8a6002c32690cc1726b05f08	478.68	15709188.408576824027639589	3913192	34	0x9ab3db94ee22e83ea83e81f121e3f5ca43859953460c183fefad0cfac80e1dae
562	0x0000000000000000000000000000000000000000	0xf5b44b236daa32fbc5560779dfe89701bf9eee88	474.3814536	15709662.790030424027639589	3913192	35	0xdf025154a9b6c009f85913f293a0b475e56f944b3e89e22ff3ab5ac472233f89
563	0x0000000000000000000000000000000000000000	0xa8638085d18c050e0d7780e557a21b5e028f4d70	478.68	15710141.470030424027639589	3913192	36	0x091904d68cf372d8925e38d9ba3f43fa5c588775b9875b278e2b8062c7b4f1a1
564	0x0000000000000000000000000000000000000000	0xc233aa1f6cad0a7d1f5420d88c0db8a61fd75228	239.34	15710380.810030424027639589	3913192	37	0xb4fb5e0117f9316cbbf6d759d3a342d5a5691e62492976ae374016b6a5482fd5
565	0x0000000000000000000000000000000000000000	0x6b9c39b748444ada91e5e60e9c7246353fb03b06	957.36	15711338.170030424027639589	3913192	38	0x63d5552b2d226e52769ede01099cc7bf3aa8fdd26222e7d9cadf46fe0f83728d
566	0x0000000000000000000000000000000000000000	0x8186fea9809f0d6f62d69dfd5f03bf21a02cbfe1	30156.84	15741495.010030424027639589	3913192	39	0xbb247fab233443d75958101aa80db83e6b656403ae9d6af1ad99a0509ffa744a
567	0x0000000000000000000000000000000000000000	0xa613456996408af1c2e93e177788ab55895e2b32	1579.644	15743074.654030424027639589	3913192	40	0x13d5ed3c2168c1f91de7c5117986f5dcde495593a966f374a38d3cb23bbeb045
568	0x0000000000000000000000000000000000000000	0x0040f370affb9da0faf5c45f70106b01af1bb3e9	14360.4	15757435.054030424027639589	3913192	41	0xff278a20a06bdf4ab7098d42a33607d5ced59b02ce9b05ee37d9706323fc3c98
569	0x0000000000000000000000000000000000000000	0xea048894bd4fd0b72a08b5ece63edd441ed05068	1914.72	15759349.774030424027639589	3913192	42	0x2a1268a56cfcdca2be325190aa8c8d2823c27d16c745f8299fff5b082a54065c
570	0x0000000000000000000000000000000000000000	0x4cbf1609748665388e4a0a3085bf73c948232de0	478.68	15759828.454030424027639589	3913192	46	0x4bc49cbadba84ea4c77bddd2e567bea109f6e8ead2a3049a7804005632890d05
571	0x0000000000000000000000000000000000000000	0x17284720e250448e1093ebce4a6762d88ee407c7	198.6522	15760027.106230424027639589	3913192	47	0x635f2ddb106a2fef3f8d0c304a9b10ec82ac90c3342af9b1de5d3c067a1e0527
572	0x0000000000000000000000000000000000000000	0xb8d0ed13b7238c954a75b48d2b0a6db359635dd9	2393.4	15762420.506230424027639589	3913192	51	0x4cbbb41ca646546395510c62ae7a40951eb9df0b1a5273b68ecad2dc6629eec1
573	0x0000000000000000000000000000000000000000	0xeafd621cdb0d6e576ba86c321c30407eb7d7fdbb	478.68	15762899.186230424027639589	3913192	52	0x7c1821134d28b064ec224c2a69561f289800140f5585698b820b558b80156392
574	0x0000000000000000000000000000000000000000	0x4f296fc0e5f32fdda7da406e1707320cc63c2ffc	4786.8	15767685.986230424027639589	3913192	54	0xc4c203c19fd16e30c7740e252b256f369081db3051b97a0844107fe6c994b4b9
575	0x0000000000000000000000000000000000000000	0x1d78010ae098d2ddfc01c7306f16776d1409a576	3350.76	15771036.746230424027639589	3913192	57	0xe834c1b3b263faeaea9d3c1fd01ab335ebe78407b1a9061ea0cd3d76209fe742
576	0x0000000000000000000000000000000000000000	0xb8a1d4686d373f9705d88662b3f520d64a267f16	2345.532	15773382.278230424027639589	3913192	58	0x9fcd468e4c47ac7839ce7baf058d3d3e090d5fa52a4833eb9859e0e1632a53bf
577	0x0000000000000000000000000000000000000000	0x55e58ab6ec98e2abfc34a08256057332867134ac	1436.04	15774818.318230424027639589	3913192	59	0x77549bed01cf3a7f6f3e9da0520ab800c87c34c4e8207db4596912b89a1e39ae
578	0x0000000000000000000000000000000000000000	0xf723fac31d10e370bf489eb0c5097217ad4e3a48	143.604	15774961.922230424027639589	3913193	2	0x73a41b7ca1b36c33cad7f0bff558dcd43e64ad1672ecca9ad7602ba7634aa897
579	0x0000000000000000000000000000000000000000	0x7b5e7fa8e19db6f3488d064c5f0ae519f439a643	191472	15966433.922230424027639589	3913193	3	0x91207f71925e43202fa0fa3355ead97633cda111fcab54e8baa539b51a01bac2
580	0x0000000000000000000000000000000000000000	0x639631fc10ea37df5540e3a6faf1bd12ab02a02c	2393.4	15968827.322230424027639589	3913193	4	0xf12576f96a09629ec0b9fc3a13c3bc675e26eab627919090b2d9ffd4d8b8e551
581	0x0000000000000000000000000000000000000000	0x87144aece4b847a01436a968b5c20616ea068099	287.208	15969114.530230424027639589	3913193	8	0xe868bafb7836c499c58ee36c78f8163a446b2925adc9d066578e851d1379bcc8
582	0x0000000000000000000000000000000000000000	0xad5220c1afc74f861739b31b3d63532ad1d3ea85	18668.52	15987783.050230424027639589	3913193	10	0x346d4d514549257fcddf19d8f6f52edf15c1bddfd1770f54aa31face523918f5
583	0x0000000000000000000000000000000000000000	0x0ec7d13e38d9db4c387ec7a57b14895c44ef5a49	1914.72	15989697.770230424027639589	3913193	16	0x9ae6b2fa2f8e2f88eb827fe91a87debb975006a92f58d9991657934ecc51e4f6
584	0x0000000000000000000000000000000000000000	0x1e1e1fc92d294a4a9f76586b78369a5da648e7d1	792.3966234612	15990490.166853885227639589	3913193	25	0x078b0d25dbfd6544b9dcd34f215eeb214994d618d55ab51a783952032cdfc8b3
585	0x0000000000000000000000000000000000000000	0xbe37ab5c88b56172bae3348ab9d095ad740425b2	2872.08	15993362.246853885227639589	3913193	37	0x6e374b4ec543b1cc45636de750b055139eca34435258440763c4d5d1bf579777
586	0x0000000000000000000000000000000000000000	0xa1d0d2cf2a877f798779aa9a173983cff62d89e2	1388.172	15994750.418853885227639589	3913193	48	0x249c965373b1d8d91f641e67a04077768b135a9ddd0c144579db131bb7344955
587	0x0000000000000000000000000000000000000000	0xb33ee0032f0afd1bc7d197ef54ed1b6c37c1c382	4595.328	15999345.746853885227639589	3913193	51	0x36de63614ca00726aabb2f62e48f03f7b40a921ceabc2e833929a698a01b3215
588	0x0000000000000000000000000000000000000000	0xe0d62c4aec72ce9c62e3331e62e436c70b77234f	81.3756	15999427.122453885227639589	3913193	52	0x4a7adddab2fb8c9ae06a89a67f31d1aa18c5ae5e9dc6f2fdc7295668ce07fabf
589	0x0000000000000000000000000000000000000000	0x683d7d8536b67dce9fa2f3d2b64eaa2969d8cfc6	11967	16011394.122453885227639589	3913193	61	0x810df59107d88c818ccc2dddcfee2a8da15b2850e8ac4fcf5ff7cea79de47fea
590	0x0000000000000000000000000000000000000000	0x9951c3314308860df9aed5524987ca69bbf9dfd3	239.34	16011633.462453885227639589	3913193	63	0x89f288c8be8fc977a37f0e01b390b11206f7e7352ef8567cf66e0a9bd33ae8cb
591	0x0000000000000000000000000000000000000000	0x1a7faa51285d75a18674d091405fe141da9aaa4f	2632.74	16014266.202453885227639589	3913193	72	0xcb62cb27fe123e5c7ecdb88efac94c004eb6a98dd237fdb00afcf1a75aa4a5ce
592	0x0000000000000000000000000000000000000000	0xd1f7ba51a0792719bfaad36d5401f9211ecd5913	23934	16038200.202453885227639589	3913193	78	0xdcad73b4e532172e16a2169860cd9fd934389c3e6bd6fd98c9060079616c57e9
593	0x0000000000000000000000000000000000000000	0xcf566a9e8048087a3124e85962751a6e8ad3ab78	5792.028	16043992.230453885227639589	3913195	0	0x61cc1c50bed96205dd025c518808707daea46f1563c58bd8ca95bdd12a316756
594	0x0000000000000000000000000000000000000000	0x6b0119959c5108237f47660511896f09641c06a4	1005.228	16044997.458453885227639589	3913196	1	0x64882a7cc3f19af5ae22ca3c097a4cc1ecb1e290c8a1e9eca2eee8ac2f6e7415
595	0x0000000000000000000000000000000000000000	0xefbb4e982b088d52d5505b5f8e337af07f9be343	478.68	16045476.138453885227639589	3913196	5	0x32aa73349e02ae9f1eda9dcdeade5e0836305ebceeb61619c03f39b611cc7b79
596	0x0000000000000000000000000000000000000000	0xaef968660ea4a3ee47b5156f2bb586ca66a386ba	9573.6	16055049.738453885227639589	3913196	6	0x4aa77e83bd9812fb348d3f11c6700710455d20f34d1e6d7a9630846dc2345155
597	0x0000000000000000000000000000000000000000	0x700a2ae2e1ebbf33a38763ed9ab73fc0479552c2	1914.72	16056964.458453885227639589	3913196	8	0xf0c5edce99535828fea54d47c0e9ef97543825a4b91765ae083b5363da67f169
598	0x0000000000000000000000000000000000000000	0xe946258642be3dd511d2d81b13962b0f5801aec2	71.802	16057036.260453885227639589	3913196	14	0x025d7e55b3b3a409ecf6f9f28c662de2838f80edcd75c04ae3ea637109559e25
599	0x0000000000000000000000000000000000000000	0x0087524dc4531f9ea7f85c5ad8c7722361b4eee8	47868	16104904.260453885227639589	3913196	15	0x4a8cf0b66af4af6c14c74cd68d698ebf500a2230701e2ac6c7fd152570b3f1a6
600	0x0000000000000000000000000000000000000000	0xe8b3a424b0ea3528197083beade96af518b7b950	95.736	16104999.996453885227639589	3913196	16	0xace254508ee292638ec186689835d98066fa0171bbf27612e5f12221d10696b8
601	0x0000000000000000000000000000000000000000	0xbf0a9bf5b7a9099b6b8bc66bb9a0b47aaec978aa	287.208	16105287.204453885227639589	3913196	17	0xb77b6b18aa4140ba77a9963da58dbdfe640d676debac4ba83461bd649e1927d0
602	0x0000000000000000000000000000000000000000	0xb4847048c87f434ef61e5f25a8ff57b061fd2de8	1436.04	16106723.244453885227639589	3913196	18	0xe3f1c0fa6239898ede129d7611a5eea6f820a47ed2911d76f7021f4607c212aa
603	0x0000000000000000000000000000000000000000	0x920896e5679dea5fb6e4c9e7704ecf908abbea15	1337.096844	16108060.341297885227639589	3913196	50	0x1652150f8e6e67923ca7519abdcf9440c15fb17893fdebd66522b2865a4711ed
604	0x0000000000000000000000000000000000000000	0xb63d52b947355749b6c99ba10362666d77ea0141	977.68427412	16109038.025572005227639589	3913196	58	0xbf08dcdbc4db87dbdae36fb759eb13fc9ab3520c6c753f2b86fca27058c6606b
605	0x0000000000000000000000000000000000000000	0x1a72ee1c0c32c98736552917c581a67db9670e9d	4308.12	16113346.145572005227639589	3913197	1	0x8629581c3fcc21cc97350051b8630b12a29ce86b6583d5946b9ba7d04b9ce3d8
606	0x0000000000000000000000000000000000000000	0xaf34a43c3b6e950f5e62660aaa637a220e36e460	718.02	16114064.165572005227639589	3913197	4	0x8f3a68137b82fc6c4f8796aff05f454820db7875a9f2ee51496976f16ae52a38
607	0x0000000000000000000000000000000000000000	0x4ebc9a6cf7d614be4c6da4d72212dbc2edc1065e	478.68	16114542.845572005227639589	3913197	9	0xce071a612ad90b55cc651e4da240efcc3e1ba2ae103dd80be1c7b87b910828b2
608	0x0000000000000000000000000000000000000000	0x89232066f05dc590293e96b3a4785c9c6ef04652	9573.6	16124116.445572005227639589	3913197	10	0xf304cb787b0cdd81bc5df1d46dbb6f68401f082e83cdb4672454863ee2cbe90a
609	0x0000000000000000000000000000000000000000	0x560c36d10f014024f5672d888158a9cb64ffdee6	95.736	16124212.181572005227639589	3913197	20	0xffde1242b9e79718d2d5b3ce38b19b1a1d310aa3328d0952ea82f2833ed3f931
610	0x0000000000000000000000000000000000000000	0x17cd8a199ba8914bf8bcbd6d04ecf5ed4cd4985f	957.36	16125169.541572005227639589	3913197	35	0x0121d2b26122559ec046528d69417b543c35459d8e62fdf35c0291d282dc1557
611	0x0000000000000000000000000000000000000000	0x97aab04a95ec46651bf50ec978c93732fcbe4fcd	718.02	16125887.561572005227639589	3913198	30	0x91fab346115b5d5aad3df09f05773ec9949a9b42252af31da91c9416ce31162b
612	0x0000000000000000000000000000000000000000	0x52284b841362691e77545fa9c65feae2d8b7355d	861.624	16126749.185572005227639589	3913198	43	0x8874ca9c3bf7c73377ba977dffc1bd9574074bc6ff5a7890ae6e790722ebebe5
613	0x0000000000000000000000000000000000000000	0x2db3c22da3ce43dc3314f24295c1d57f78d3616c	718.02	16127467.205572005227639589	3913198	44	0xb9fe7030ef8f2dcc1672b7d7091244f2541e3857b436f1a14546237c17561f5d
614	0x0000000000000000000000000000000000000000	0x7d0bcf7165989cbd8bf43b62eadfce4628cd3b6b	478.68	16127945.885572005227639589	3913199	2	0x4641039bc494090c05ada1c67500fa8cb37d298daf5062ae5cbd54d506a4a491
615	0x0000000000000000000000000000000000000000	0xf1a499d73b707a2d2284387eb27622cb0a82aca0	1436.04	16129381.925572005227639589	3913199	15	0x0900e31f885aadfdde31a6677736df64b3b7abb319930b8684f60a4d6f4ef3a5
616	0x0000000000000000000000000000000000000000	0x4ce37b6f2d29b35ea7eb1a604e596f5b3388b07b	7180.2	16136562.125572005227639589	3913202	6	0xc6ca96834b0f50f59b141cc78deb620372e2ac30a5fc56aa3cfe4e51188c9d9f
617	0x0000000000000000000000000000000000000000	0x4cc158485c81359a5652ffc6ec79d564179cd085	478.68	16137040.805572005227639589	3913204	1	0x203e1c7c917753fe08e7a0c0800929a0314524029c40a607e3fd2438435c492e
618	0x0000000000000000000000000000000000000000	0xcf0489ae7bbf3b7321841f3ce9db682a6b0cf612	957.36	16137998.165572005227639589	3913204	23	0xfc75e50695ba56dadca4e6ff6678259b633c2feecce619cb17c2e84a9e9f0f4b
619	0x0000000000000000000000000000000000000000	0x251793b81538505f44a4b65f66bcc7e16b73a9d0	1436.04	16139434.205572005227639589	3913204	25	0xf9c907364c9a5f5b81b09ab5fff55096d8388a8447e024974ba0e640715dae56
620	0x0000000000000000000000000000000000000000	0x40c273ea3eee73d08a1dedaa4cfeed554a1ff68f	4383.398962782879558409	16143817.604534788107197998	3913204	26	0xff3da4a23248eff73baa8f589552957965ee1bfb1d806170c03ceba6052005e7
621	0x0000000000000000000000000000000000000000	0xf723fac31d10e370bf489eb0c5097217ad4e3a48	95.736	16143913.340534788107197998	3913204	27	0x5bf74ef653815a3f70266f6c592a86b2f82fbab78ca2dec91b4dba83a5336603
622	0x0000000000000000000000000000000000000000	0xd3232365815c9d757e6274ad30ecfb5d89ac92dd	71.802	16143985.142534788107197998	3913204	31	0xb9578da65f195fa0d340ea92788f407b2b5776cbf5018fe9915d2cc34328239f
623	0x0000000000000000000000000000000000000000	0x33c41f7797facc50358578f14d0fce68a32e7422	1187.1264	16145172.268934788107197998	3913204	32	0x47ebc0879972af4b2f8acac77e7cef78c0f6978d9bc97ac4ccee0723f588a4bd
624	0x0000000000000000000000000000000000000000	0x39ec5ca9296f3ccd50921bc97909ae06db90958d	1436.04	16146608.308934788107197998	3913204	33	0xb047bf7240e8dca80d7e95f86b0a697aa3ba88204128d12ac383fd097cb4e432
625	0x0000000000000000000000000000000000000000	0xb7b3ecbc3fd793dd150b57c45d1518469e6fed06	14360.4	16160968.708934788107197998	3913204	34	0x2fa7076b1b811f03481a937407b48f05c24c6beab3186e8dec9325af74b914d1
626	0x0000000000000000000000000000000000000000	0x0a03d2d715c5263ba83593db7f3697b96575d53d	57.4416	16161026.150534788107197998	3913204	35	0x49b386acc7c8054f75085293aaa7e030aaf5f833194211f7b10556b551f7e025
627	0x0000000000000000000000000000000000000000	0x17bcefc1f6afeb3e849558fa8917e464ddb0eaf0	215.406	16161241.556534788107197998	3913204	38	0x067d9b7662411a5b845188f44f759c95e3e515a484dfd731c863f61df7e03149
628	0x0000000000000000000000000000000000000000	0xf7ff150d81894beb14dbe332f7460a6f25b5ccb5	1483.908	16162725.464534788107197998	3913205	2	0xb60ffb15e940e0b53b3707eb0c561c857416c6f9f53f14933e661165c2018c5b
629	0x0000000000000000000000000000000000000000	0x19706384953ea11dc3bf7ba862304321a954b17e	19147.2	16181872.664534788107197998	3913205	3	0xf1a65a7a3576a085eeab18f10864a4e198ced71c86aa5b178eab704d1d56d834
630	0x0000000000000000000000000000000000000000	0xc0b860316e8cdf37da8b0abfdabfa1ea51715032	239.34	16182112.004534788107197998	3913205	5	0x31def3eb117529b6e8082acd8881d3200e9bd6bf1f84f32b64105b0a473348e3
631	0x0000000000000000000000000000000000000000	0x5fb879012f9ebfde3bb3db71ebb4c3b0bbfec55d	478.68	16182590.684534788107197998	3913205	7	0xb42ca3c0f83250d433feac0c59fa71dceddf878e20b211d9d5a55e56f29588cc
632	0x0000000000000000000000000000000000000000	0x86952daa5b0ed25aa53c2ac05dd7b498599b09f2	47868	16230458.684534788107197998	3913205	10	0xb9806e3b144479ecc55e22f9cfd26bc8e1bfabdaf44f78445a1e004ad90b1815
633	0x0000000000000000000000000000000000000000	0xc07380736c799ca421404f9a0b931f382aa975cf	483.85087602808603344	16230942.535410816193231438	3913205	15	0x549ab3bcc81a2a67f98ed97746fce6cb57a4d4c15fc622244ec4fa19035e37e8
634	0x0000000000000000000000000000000000000000	0x9d06610b6e3531c75f29a786bcc5ae560a5004ac	2023.8751906632	16232966.410601479393231438	3913205	16	0x6b58e010997bc7a7854a38b850270507f5288ced925723ee0aab1dc5ac77d292
635	0x0000000000000000000000000000000000000000	0x97c5cab35cfb7491310a3e20c04324f005007758	1053.096	16234019.506601479393231438	3913205	17	0x4ab5d322ebda251e9eab929c60ea2b65e305845682b1af1d366ff061bbbdb9fe
636	0x0000000000000000000000000000000000000000	0xf6b7cc311edf84f0e32553f989ea6d3b63d56268	119.67	16234139.176601479393231438	3913205	20	0x0960321917349639a59b2d7e0b7b1c2725711b04b1f07efd839aa5e802592481
637	0x0000000000000000000000000000000000000000	0x3c154d6a5f53e66085ce1d7c26f23aeb6d6b18ac	3446.496	16237585.672601479393231438	3913205	36	0x5849774bafbe14d1c7aded8fa5e871b825f813f621556ee0e0ba7d9fe11c86b9
638	0x0000000000000000000000000000000000000000	0xee4251abd5b0242b091aa568a2826eee55670416	445.1724	16238030.845001479393231438	3913205	39	0x76bed0c0de553b1447368ed64af09859b8ede20541da5206a419c4b431584f34
639	0x0000000000000000000000000000000000000000	0x459316f9531666f6a2ac909ad6279b24d29ed529	26.6672628	16238057.512264279393231438	3913205	56	0x11d26899d70085b930f963f7e2b850d98ae772fd80fa12c3b3f67c4a0fe86429
640	0x0000000000000000000000000000000000000000	0xff2e2b372fd33d738ec705b4276ac75537db19e2	23934	16261991.512264279393231438	3913205	57	0x2ca278e60e213062b75f98826c537b1b665bff385b0a5d575f1075ea54918594
641	0x0000000000000000000000000000000000000000	0xfa11dcf8a74e6d607f89a756d4cddd78cf35bc91	142.598772	16262134.111036279393231438	3913205	59	0x4759b5279d92c66680f8928ec5dda7f1956d9cf04eb355269639798f5f567cb5
642	0x0000000000000000000000000000000000000000	0x1916a0f94baf2219f36cbbaa1e2e705ebc531682	478.68	16262612.791036279393231438	3913205	61	0x5f3bffcad4f840127c586f2dee3ae99cf6ea368888de9d4d03d636a9720bc322
643	0x0000000000000000000000000000000000000000	0x5865c90dc62ee5c5eb02ae3fbf778e335a4b8772	23.934	16262636.725036279393231438	3913205	67	0x8b67a560fea9b1b71c0ab97d00d94772a553c1f32d415bcf9281e14ee989fc05
644	0x0000000000000000000000000000000000000000	0x3000eca3ab1d8dd73624b49a085f4ed023420c64	3063.552	16265700.277036279393231438	3913205	71	0xa378f7eb790ef9c9910b394168ae5bd600252ed370edeea5308945a8394238d4
645	0x0000000000000000000000000000000000000000	0xde7a66c42e51720c7b98dc6d2c7a8283fdc27084	478.68	16266178.957036279393231438	3913206	3	0x009fb885002ad93aecaaca081354fc08ab7d6d613d35bf3a0a8d06aefa8f3870
646	0x0000000000000000000000000000000000000000	0x4b3a22f7bf9345b0fd668a86c28daf374dd517b5	1182.3396	16267361.296636279393231438	3913206	4	0xb62de68fb45d12c0787a5954665d5964b7f76ee31703d3090c8af26df489a7b2
647	0x0000000000000000000000000000000000000000	0xd213f47b373c4a0f79f79584e5c1b6385e5ab308	478.68	16267839.976636279393231438	3913206	5	0xcb3578c3bd3fa9933869dc2d03dbb78a37d1da500f023de7615b2104bb5eaed5
648	0x0000000000000000000000000000000000000000	0xdce766d46a5fb7692ac135260126b3b47b7f30cc	6557.916	16274397.892636279393231438	3913206	6	0xe11bdc1c614fca544f0f827099f62f4a12d39f1e75833db8dd6e2494d159b59f
649	0x0000000000000000000000000000000000000000	0xe4f8b574ada2289630671ebeb12585056a9c7fb7	239.34	16274637.232636279393231438	3913206	14	0x209177f14430cf792bb56bde289347cb50a83a8654d7bbe49934e327b5db028a
650	0x0000000000000000000000000000000000000000	0x5ad21dc27c6fc36725d643a19c2245c5327ff915	957.36	16275594.592636279393231438	3913206	16	0xc46faac60012252cadff916167ebafd27a874debebe21644bd4f2577ceb8581b
651	0x0000000000000000000000000000000000000000	0x2f663550ac44e290c7dc8cbc044910a4d076eb66	478.68	16276073.272636279393231438	3913206	19	0xbeed988720aeea2d57e0f36752ff10b464ad13d5624d8bc6215f1c94b3606aaa
652	0x0000000000000000000000000000000000000000	0xb678692bc572acb16bb37e17ca9a3d149f657390	813.756	16276887.028636279393231438	3913206	34	0x8055f1c2ba1992cc28054d2120f20fa5550df5dfe8f2cf602470c1239aea75b3
653	0x0000000000000000000000000000000000000000	0x383db0fa23ff86a2e668c1050ccaac3f67d23ad8	4068.78	16280955.808636279393231438	3913206	61	0xf4d46ca43fad6d602f0f3ade18e9836a7c6ca41240e47fc7f1b45520713c0393
654	0x0000000000000000000000000000000000000000	0xdd9da16f27e420e62c8c1fc3b98e0122fc5f6520	95.736	16281051.544636279393231438	3913206	71	0x902f16d665dd0d9cf49fbc49960625460add7191b5c7a60fde5d7494976b09e2
655	0x0000000000000000000000000000000000000000	0x5e46be17e9dbadca7c7289e9074c5a926f70e958	12.44568	16281063.990316279393231438	3913206	90	0x3d8e759df0f1ba9ebdf0547622e014b7c0da04681ba2457f62831cb9baeda358
656	0x0000000000000000000000000000000000000000	0x4ad9178b47868752beb5aac9685388cac1f1cb7a	622.284	16281686.274316279393231438	3913207	14	0x265495114b3832522e7f639218ef4c889f726d8f631700a50b8ecdeea15e4304
657	0x0000000000000000000000000000000000000000	0x97d1063d58b9591cd6e2f611e8e1946dcbcbf93d	239.34	16281925.614316279393231438	3913207	16	0xccdf65b0cf3aa9fd5b6c4b2eedb3544f903d1f7b59bf1e92e24138abd06228b2
658	0x0000000000000000000000000000000000000000	0x55d05c7aff7f5b5fc5a0f789312896261148dec9	521.7612	16282447.375516279393231438	3913208	2	0x0aadd7ea405de78e741d94d43af052cf2fd2d29919781e0ea5abd87d20423a66
659	0x0000000000000000000000000000000000000000	0x40f903869321ed1df7a5a01c7beb6fb122c19b17	478.68	16282926.055516279393231438	3913208	25	0x92e9247e2be1c227ead442d4d98c8c7eee0f2af38f57b68f8e9c244c43beea01
660	0x0000000000000000000000000000000000000000	0x8fdd785c12c39fd7a4fc57c972af4415d1eda0e6	478.68	16283404.735516279393231438	3913208	29	0x7f8a890ed8dcef2942c0b54289956ba4932ed2787cb32ae68d7d8f5eac3e82ed
661	0x0000000000000000000000000000000000000000	0x151797660e5802b2a3a8aa853f96608dbf850e39	28.7208	16283433.456316279393231438	3913209	0	0xf5b9de986d983a13a8e1b6e374caac80e65806f45295dc1489a4218b8e5cbaad
662	0x0000000000000000000000000000000000000000	0xb45cca0d36826662683cf7d0b2fdac687f02d0c4	3829.44	16287262.896316279393231438	3913209	1	0x6d67cb0fd50d7d6e7dd5efce875463d4dda5bd48c97263311487d86fc5e1642b
663	0x0000000000000000000000000000000000000000	0x04994e980f070a53e28cb24319db99b0ec91897c	12.44568	16287275.341996279393231438	3913209	7	0x9a864a3f8e44616032287ab646a31eca822a7b2da0a0d18e6cbb1ae01628febf
664	0x0000000000000000000000000000000000000000	0x55a0b2b1a705dd09f15e7120cc0c39acb9ea7978	28720.8	16315996.141996279393231438	3913210	1	0x99703dafbff7643f12e2a30e0cbc53c38d44f1dc8f2bb5d15d055819ce081cc5
665	0x0000000000000000000000000000000000000000	0x761fbe74afe6edd836da3b21877f6ee4591ee93e	8808.66936	16324804.811356279393231438	3913211	22	0x435dce530bc126459e209746e7fd7cacb19a5e50716ecd01c966f2ed33647361
666	0x0000000000000000000000000000000000000000	0x5113c12e12427747e73b87b76bc524124acb69d2	9573.6	16334378.411356279393231438	3913212	0	0x37431e27f750913f6500ba7c0bfd5d65ae7eb6b522135b728ecabc267b4b46fc
667	0x0000000000000000000000000000000000000000	0x605c376002b4300de4d5be3345d3ec35783ae315	1914.72	16336293.131356279393231438	3913212	23	0x6024321f93f092562b6239a80aa25f2d82d6a15b208c402080d88abe5a11b1f0
668	0x0000000000000000000000000000000000000000	0x5e91a5f226299856d227c552827aad9859227be2	2388.6132	16338681.744556279393231438	3913213	0	0xb184a00fc93a0ad51875acc2e6ea2836a2c5f4060e2eec3cd48839aeed1aabde
669	0x0000000000000000000000000000000000000000	0x6994094171e0fd59646e9b22937552fee6b8ccb5	1153.6188	16339835.363356279393231438	3913213	2	0x601d40c03b30b63215ac802ffb7653fe4188d5b015a61732cb76353c3daad680
670	0x0000000000000000000000000000000000000000	0x4903e86a86a274782f05f80b48fc1552530a8061	3350.76	16343186.123356279393231438	3913213	4	0x0d10975469855889f41f9a424f90d4607daaa20a17909f73324f39ccf098dca4
671	0x0000000000000000000000000000000000000000	0xa1725add1f825825610ded10ea636fc9f673948b	6462.18	16349648.303356279393231438	3913213	11	0x81699066a81bfa174b42f0aa410f45c4e05df9a65c8dbf5bd8f2512787cb3a1e
672	0x0000000000000000000000000000000000000000	0x05c2deab3e3486b18ee8a1e5787073154340e22b	7180.2	16356828.503356279393231438	3913213	12	0x5490b71587becb35c6f91c1c1c676adbe334c2d4f5e8a09d6714e29b31090934
673	0x0000000000000000000000000000000000000000	0x2ecb3d65993040d26944b347119eefa31f7bf3b4	957.36	16357785.863356279393231438	3913213	18	0xd09272116a263206fac91e2daef20bbd5e7835912743d8be161549d31fd14398
674	0x0000000000000000000000000000000000000000	0x0c52f8bb5f046b73140a6ddceca0459db5eeddab	2393.4	16360179.263356279393231438	3913213	31	0x05d0f9e3f05d3d2ea66ff2f3be2cdcc1b18dbbd9bd1a62e77d65d3cacc67aa20
675	0x0000000000000000000000000000000000000000	0xd2b978c9187e69482931016fbcd0a078062e155a	148.3908	16360327.654156279393231438	3913213	53	0x9f0a785270a405888af61e8d336ea97dc8f4f5763a65f0676740b23f0d198e4f
676	0x0000000000000000000000000000000000000000	0xec286f8be15c3acbcb9eda7a5c4393fd18f44bba	957.36	16361285.014156279393231438	3913214	48	0x133e6eed6f45a14a4b318b501a3ab02b53f753c347eab06246bef7e99de9c95d
677	0x0000000000000000000000000000000000000000	0xe8af12e3c4d34d3aa27a38258d6ce1b803a37e02	4786.8	16366071.814156279393231438	3913214	54	0xd6f14b7209f988a4958b93c5e835cfb9d0ebdc4a48af04c3ddb8fb6f0b781fe2
678	0x0000000000000000000000000000000000000000	0x12bd7ebdee1f0b2382b5f759bd66b6968c38513a	382.944	16366454.758156279393231438	3913214	55	0x617adbfc05377889ca6aa4960e4c15c8ea9db8d9b38e6222d4d5ad4f16099d40
679	0x0000000000000000000000000000000000000000	0xca8027589471977ab2c386d4c6284c8f73330234	311.142	16366765.900156279393231438	3913215	2	0x2b9c13e6fb09bf849d1b1600c09834db97a7a8961820f30bd4b21c42903517c1
680	0x0000000000000000000000000000000000000000	0x00a920e243c267ae109ff763bac80a1758557894	11967	16378732.900156279393231438	3913215	3	0x32bb2d184d1bef61acac3d4fe9a8e690f761f71239c13bade8d6acf25621aadf
681	0x0000000000000000000000000000000000000000	0xd682bda378e3b635d28effd8a2a662d48ecf115f	957.36	16379690.260156279393231438	3913215	4	0xcb079fef0ab07f46aed0b7269292c89c99ded9f5d348e3305edfe771bd095582
682	0x0000000000000000000000000000000000000000	0x3753ab76624d6470ce49aeeba5cc0dd5edfc4c93	8265.84624	16387956.106396279393231438	3913215	46	0x703d9c42a2289b20821bf5751aa77544372efe12cc08560323d49a9ad48f6f89
683	0x0000000000000000000000000000000000000000	0x411ee8d7e63389a5ea3aeff1f79363c0132d6859	957.36	16388913.466396279393231438	3913215	49	0xea0e3386f5f2f00ea1c6258cb3675099886b4eb01812b32b511fbbe906b170bb
684	0x0000000000000000000000000000000000000000	0xa16840bc08c6d03925939b36d40cb48fe982d028	234.1119671364	16389147.578363415793231438	3913215	51	0xfbcf9b3d42f4f2f14a50e6e045399f859a5c47f00e3b8dac69753d0f4bfc5af4
685	0x0000000000000000000000000000000000000000	0x2298ea5e86ec717d181d0f68ed00fda0c2e35d33	26.758212	16389174.336575415793231438	3913215	62	0x24e6b3c393ff8299e40cc0f467c3134eb8492d4cfe3a078f866665ddf156d188
686	0x0000000000000000000000000000000000000000	0x180d932fbd59c12c180087085cdcdfa50f20c7db	478.68	16389653.016575415793231438	3913216	32	0x61435a5413f8930062fe5336d836f182f4033778f706701d56f7d67f3c9ee0c5
687	0x0000000000000000000000000000000000000000	0x5326b57f1184ee8a1a2fcab2f2562fccb8027f7a	239.34	16389892.356575415793231438	3913216	34	0xbcbaf2098443fb6e17e8afb6f0161d96abe6eafb22cf70127d1bb126a4f24bde
688	0x0000000000000000000000000000000000000000	0xef5feaeb48d2512a34e6eba9f7e637f1b49f8254	607.9236	16390500.280175415793231438	3913216	35	0xc356edbbc2b6f82f24deb79466212ade4bccc61fbcd3d0026813dbcbaf6a16cb
689	0x0000000000000000000000000000000000000000	0x1b22a64ea64c2f4cf1d6ae25c855db5fe1ca0e20	14360.4	16404860.680175415793231438	3913216	37	0x460243c50478997f93b2913dd2c0f7d05b3a631c80cbc5cf24fd3fde7931e214
690	0x0000000000000000000000000000000000000000	0xe836c830a9819b644e7c80c7f4c1edb480f8c59b	1436.04	16406296.720175415793231438	3913216	38	0xb43db71c53ab6b316facf1147e25dd9ec8f1f36d2f8eddfadc0a11665d2cad7c
691	0x0000000000000000000000000000000000000000	0x2b9d22382980276052456509ad2009b9eb7b6521	143.604	16406440.324175415793231438	3913216	45	0xd4c5dc07c1f63d93dcb384ef157e95b53de86658d81f16779b9e4d9d2748e658
692	0x0000000000000000000000000000000000000000	0x94e2c45be73cf6ad58f4b63d0c4b2f8f55cf7141	1436.04	16407876.364175415793231438	3913216	49	0xf1800b6799b29901e6287d47ea5ead8dbfcc95c7cd5ba68b64971d3ab7fba991
693	0x0000000000000000000000000000000000000000	0xf052c41ecdbc42ef0c6b8649b10e6c7aef987641	19147.2	16427023.564175415793231438	3913217	0	0x035b454d325b8d94f8ef257e9f5f7c0973f8bbad1630a3bb09899fc7dfc29632
694	0x0000000000000000000000000000000000000000	0x9c3fbdc000964207e3a8607a8d79e32f8514c322	95.736	16427119.300175415793231438	3913217	24	0xcad8562ffc4f6dbe63ab498cacf246fc852e27572a4d17b324389270f9b86218
695	0x0000000000000000000000000000000000000000	0xe933b93898c9688ecb77949907c9437190be650a	1436.04	16428555.340175415793231438	3913217	38	0x0bdd2cd869e3ff3492fd36c3001b4af3a1b3b54aff3fb009924b2a496d8c5bbf
696	0x0000000000000000000000000000000000000000	0x7a82fb208303aab2369105ba03c9c0146ac8fd86	239.34	16428794.680175415793231438	3913218	6	0xd8ee0e4c104abdabc42bc1759b460adc23129c771ef894c4221dabbc38dbdbeb
697	0x0000000000000000000000000000000000000000	0x6d6bf8a1dd43b5cce6ed6f48c5110304f5d61731	143.604	16428938.284175415793231438	3913218	11	0x66c7281530058a8240db0ce5d1391db28812f4bbf123966c3d04dc147a8c4c8d
698	0x0000000000000000000000000000000000000000	0x00c84b0d12a70d0b4f2473b93da369be481eecec	114.8832	16429053.167375415793231438	3913218	12	0xc190674e863efcea6dbd2f46b2a1cfab839dd579283d2dd9e240a24d11cd41ae
699	0x0000000000000000000000000000000000000000	0x6a49478e40cad6dc038d47e0911ef0e0e5588d5d	191.472	16429244.639375415793231438	3913218	19	0x8151c96d0956cf1a82e9027af05f09d529bbcb996bcf1ba610307436b75e0aa5
700	0x0000000000000000000000000000000000000000	0x64ec44cd404d88adb4aea25e5caee45e5a3790c7	957.36	16430201.999375415793231438	3913218	43	0x5c53eb161075374e51b1e51304541426b0d5c7c95072995533726c518d20816d
701	0x0000000000000000000000000000000000000000	0x0b89a4c13fc8f9d40a0a03744016292eb32b65f5	1914.72	16432116.719375415793231438	3913218	46	0x64631a1f769291f238baa0b7a6e9caaef613f7249cfe5ae70ab5180f75309ac6
702	0x0000000000000000000000000000000000000000	0x99b3c0c5a54642e3b6e031fa28b8806b720900e2	478.68	16432595.399375415793231438	3913218	51	0x7900b95481835331925d9023f11d84281be1ceea3e9b3703abd95520ac2062f2
703	0x0000000000000000000000000000000000000000	0x402710770885913d2c6f3d10a9961713cf5aa07e	923.8524	16433519.251775415793231438	3913218	64	0xab4c5d8f7773d1d24d6aebab5a516a1b3b8800c929952bf4269fcc719af81e8f
704	0x0000000000000000000000000000000000000000	0x07bdd68020a16a44c0fd68c9c8557d86a743e4ff	478.68	16433997.931775415793231438	3913219	1	0x86006b158a401b22c5222266b9a7da5f9d0b2508c530e2b34c01711510a137d5
705	0x0000000000000000000000000000000000000000	0xe02cccaa6ba439d730028041e2dabaa5584f9fa8	11967	16445964.931775415793231438	3913219	3	0xfd15a05b2329056f5077813e4a7346dd0ef77d600da866fc4b920c604dfbb11f
706	0x0000000000000000000000000000000000000000	0x1337712c10e01c6abd22ae32d1c74f88154621b7	5907.839623389654150663	16451872.771398805447382101	3913219	6	0x778afecf8ab1e7318fdf8aa03486bdca6523e921c14417e8e57ad522cc0a63e1
707	0x0000000000000000000000000000000000000000	0xf8047e5a6c8a96858b94633974059e28489fccfa	5265.48	16457138.251398805447382101	3913219	11	0x4843e715b1326a9f7ea3cd78b88ff46ab0e18281bdb14afebdf41fb3a51381a8
708	0x0000000000000000000000000000000000000000	0x7812c529773fd9f81a26ee17b799b9a88faeb4e1	2374.2528	16459512.504198805447382101	3913219	18	0x32e1fd76a815dd388d4729cb257151cf2c581d7b41971b6d0545ecea163a6e04
709	0x0000000000000000000000000000000000000000	0x5865c90dc62ee5c5eb02ae3fbf778e335a4b8772	19.1472	16459531.651398805447382101	3913219	35	0xad4f300356d5b113e631c6cdad0bb148291b628d4780f5556e34627be05807b0
710	0x0000000000000000000000000000000000000000	0x53e48e09c42b717906e8f0e7cf562af347877787	1847.7048	16461379.356198805447382101	3913219	52	0xa13cd619589afb7bdfeedfd4427fcca63defc4977ebe41ecad9d9110d61a8e9e
711	0x0000000000000000000000000000000000000000	0xab61a20f43aaa0e3df716df76e111090b1e0de36	23.934	16461403.290198805447382101	3913219	59	0x3552d51cf5a5d5b281fbd2eae7b1932041c5b30494f613c9f2830c6ab11a45c4
712	0x0000000000000000000000000000000000000000	0x1a94274ad2c8d8b8cbb172aa45f6dccfb1f62127	1.43604	16461404.726238805447382101	3913219	62	0x519dbd15e40f8ccefa605d3994fec6c176ec229c9fe06f3230a5d8b9cc879eb2
713	0x0000000000000000000000000000000000000000	0x486ac3ed9a534d019e9e2c600ed7111aa05624a6	29678.16	16491082.886238805447382101	3913220	38	0x6f9ef904fbc584ed9285e9df26f634c95cec66577d9fe609768c24f9cd680e0e
714	0x0000000000000000000000000000000000000000	0x934111bb6536935f9f9487a3f9e029a2009b9979	47.868	16491130.754238805447382101	3913220	40	0xf6e94d927f1007232ef84fb3e482456d268d297ce5410c352400ebbee573db95
715	0x0000000000000000000000000000000000000000	0x0788072271f8e7e736e5f54990d703dfcd88e168	1436.04	16492566.794238805447382101	3913220	41	0x4173c208fdfc2cc0110fb6da7e2c27496fcb4274607444ea9c3b2772837cc426
716	0x0000000000000000000000000000000000000000	0x4f48e1b03e95b6ca0a2e03bda03211e76ec1c4d5	23.934	16492590.728238805447382101	3913220	69	0xd0eed493d9427df0487d96d3bf2d7a6175313f756419620481e88de1a2e80a1d
717	0x0000000000000000000000000000000000000000	0x7a7eec9853ecab11f2ae1644159bc0597baa8228	62.1011046276	16492652.829343433047382101	3913221	2	0xed7651ca5a5337bca4789d80b39980ea9937a92fa132625f6b6e1d1cf2dc15bb
718	0x0000000000000000000000000000000000000000	0x4ce37b6f2d29b35ea7eb1a604e596f5b3388b07b	4786.8	16497439.629343433047382101	3913221	4	0xe78f26929060e6a73549323ea0dbb6d4e5d45ff48f45bd59004df7b5d6da539c
719	0x0000000000000000000000000000000000000000	0x0074ca1979889653aaefd4b112b93b029e682288	478.68	16497918.309343433047382101	3913221	11	0x157b9e64038756f1db459125f254053eeb06d0d36ce3f5be24aa0ef1c1488233
720	0x0000000000000000000000000000000000000000	0xe1ac36d0e4c86e37981f322a9582aab2ede31cd7	478.68	16498396.989343433047382101	3913221	20	0xb0a4fedfdd49a88ccd863a421ae625b3440853e76a55acb2aa5c36eb42937595
721	0x0000000000000000000000000000000000000000	0x0e90e3eec93b3d31a51a8d7eddb4f161f0001d84	7180.2	16505577.189343433047382101	3913222	3	0xd71a8268111e0b6857f6e47ecc21ea6a1c5d98ffeae8c0f66a50d367d989c726
722	0x0000000000000000000000000000000000000000	0xdc2a23bc9455986897d2e513b9887c795b9a355b	263.274	16505840.463343433047382101	3913222	5	0x0ebd511e64d67213195bc9a06475ea4a58f32609675767054b1d1fd839c85bad
723	0x0000000000000000000000000000000000000000	0x283523827a006b3229017839ecb8126de6204271	478.68	16506319.143343433047382101	3913222	29	0xfa83c7e3727a0389229ddb0328356fd27cf36dab0436f93bf74b9a6eca62bb95
724	0x0000000000000000000000000000000000000000	0x29feaa65869e737ad53bfc2325bd8ffed8d27a07	14360.4	16520679.543343433047382101	3913223	0	0x6770afa1f6d68b10770229e6855742fd254092684c990a9f478dcd9b8bcc0e7f
725	0x0000000000000000000000000000000000000000	0xfdd3eac4535900d55d67754bfc5009f7d3c65f41	471.47275458	16521151.016098013047382101	3913223	20	0xd2dc4794c60e6183690412c4ebcfb6b3ad05357bef5fc8ff3839a6c9ef40f8ff
726	0x0000000000000000000000000000000000000000	0x0ad1fc9f0759fd214d7be8978263ce1fedc9c810	95.736	16521246.752098013047382101	3913223	21	0xf65ca24cedf021dfcd7f8754a1de1cf31723524d908191522f8950b908ad567e
727	0x0000000000000000000000000000000000000000	0x4e532cd2bbd887ac97fd1278ea2efe9f324af12f	478.68	16521725.432098013047382101	3913224	0	0x77b3df3f551fcd8f29c50e1abb4d36038af0eff056d7ef3d8d3b2e0817364901
728	0x0000000000000000000000000000000000000000	0x3b1b3eadcbbb66084869b7bb08591733ad9bff9b	780.2484	16522505.680498013047382101	3913224	3	0x27b1a5c3c7217f7e8d9b86238494b846498a7af0dd8b5da1ff6e8412533443aa
729	0x0000000000000000000000000000000000000000	0x9c3fbdc000964207e3a8607a8d79e32f8514c322	19.1472	16522524.827698013047382101	3913224	6	0x26df60903ad0e38098a53737fcf78e2ec7957fbfc8385f837a6082754c4f404f
730	0x0000000000000000000000000000000000000000	0xbad43f5074c6fa0b1ef306fcbe666836028d6ffd	2527.4304	16525052.258098013047382101	3913224	7	0x70faa2dec51bb436c53c19af656551ea30131f7e3bf034fe7d03945cf333d017
731	0x0000000000000000000000000000000000000000	0x18d3a0d803a77f70068b34eefa5a1a8dc585654c	408.810050794124127979	16525461.06814880717151008	3913224	8	0xbb95bb206952f68617c4a890a78b222ac5f50782c382e4d253c4c648ff5f94d2
732	0x0000000000000000000000000000000000000000	0x349b86dafb01eb39c3b67541953ed9a99d3f9c00	95.736	16525556.80414880717151008	3913224	9	0xf1957992da9037b09a767eeafe679c8cc9b9d5bcfd6b461f017e4acbc639a012
733	0x0000000000000000000000000000000000000000	0x52284b841362691e77545fa9c65feae2d8b7355d	574.416	16526131.22014880717151008	3913224	11	0x129320b9af305c80cd18dc9c0dac9a9f4340b42caa3dacd7759a0874dc1c0074
734	0x0000000000000000000000000000000000000000	0xc86dcffd52eb937ec7fce67550893f31d6333bcc	957.36	16527088.58014880717151008	3913224	57	0x8064f6f206d7f84d293abfcbb569b54719b36022337f1557c2e6af54a4bce6d3
735	0x0000000000000000000000000000000000000000	0xbede6e1b9417dd9a44eaddb928c136b152a6ce9c	239.34	16527327.92014880717151008	3913224	61	0xbd2e150a176239fe54b3cb73d4a63ccbb1b9a80dac64c2ab2fcf176603b1a44b
736	0x0000000000000000000000000000000000000000	0xe0e21f46206f8f6902056fe1f78a96468b95a881	478.68	16527806.60014880717151008	3913224	71	0xfc69924369062f402620674a0812f4a962fd274fa673dd70c2bbfeded5ab6d4a
737	0x0000000000000000000000000000000000000000	0x00ef30429a06df64cd36b11ac736e76c9bc1dc86	23934	16551740.60014880717151008	3913225	2	0x57831c5fbeefb87b043bd67d2726e32650398a91ecc5704e291764bd7547b40b
738	0x0000000000000000000000000000000000000000	0x2d5bd67e09addd7053d9b7a8e8a28269a5249ad1	52.6548	16551793.25494880717151008	3913225	5	0x107965d56f10e0eb5a34ddbcfba1eaf264ee3331adf9acb5f5a8ccf4207e611d
739	0x0000000000000000000000000000000000000000	0x0bb952407eadbf38108d1c570a2e7b798f136774	47.868	16551841.12294880717151008	3913225	7	0x79f20c072a3552af0dfbeb826d95865fdcac662c21277fa537a1f3e8cdc00702
740	0x0000000000000000000000000000000000000000	0x64ec44cd404d88adb4aea25e5caee45e5a3790c7	2393.4	16554234.52294880717151008	3913225	22	0x8e0fbc7e49cf74089380d6958be5deca6e5ef4daae04d784fdac5f993f324b4d
741	0x0000000000000000000000000000000000000000	0x73ac5742843e8033c517a46f4c8157927df173cf	2010.456	16556244.97894880717151008	3913225	26	0x3b08715d7813f0e13f7310857efee93761deb8cf55bca4bbff0cb1a79345b8ae
742	0x0000000000000000000000000000000000000000	0x44cbf96f34bc4cf9902273090d9512e79f159c4a	478.68	16556723.65894880717151008	3913226	2	0x04f493993a7f81ccd4b5d1ed2d0b2bb5dbd511f96fbbf5f5a7828791f4f9a329
743	0x0000000000000000000000000000000000000000	0x4de2f824a5797bbd2108ce1f9f336e0ba305c723	479.41939811934970719	16557203.07834692652121727	3913226	3	0x68f37ee7d4b8dfd67b506aef5912f3ce7e53c075641303b17ed800e080731d92
744	0x0000000000000000000000000000000000000000	0x0334a4cc5f616e3bfa7345b8639b502b20e6d679	1579.644	16558782.72234692652121727	3913226	4	0x76507170be8c10c61a1a473c179b10d26aaeaf7486f6a241753abe63ebc7acd6
745	0x0000000000000000000000000000000000000000	0xddea624f3cc3da8e9fc2d9a85cdae1118fc8d22f	478.68	16559261.40234692652121727	3913227	2	0x56129c7c7c0db13a5086993e3674e0264a71a0657480230ff938552b464ffa79
746	0x0000000000000000000000000000000000000000	0x97d84fa169270414153a100bf93d66a0177913d7	468.14904	16559729.55138692652121727	3913227	13	0x5bb13362dc6992831c1cf5da7b57f12a42bcad14609e752662577808c9901287
747	0x0000000000000000000000000000000000000000	0x1f5522d00170e5f3711ff957acf038df3c6df50b	239.34	16559968.89138692652121727	3913227	14	0x89a16967f781f43d6f5f0d441cf2d77cc900511a72ae5ef915efaea6211e06b8
748	0x0000000000000000000000000000000000000000	0xa597bbaf9f5b88592ef12458a846c9a37273f751	239.34	16560208.23138692652121727	3913227	15	0xec06852a2684fd11f76f01985071c689c84b8b780bfd988e41a99430cf4ad0c3
749	0x0000000000000000000000000000000000000000	0x2f411046d5905360aa4e3177ca16170b9c08a295	199.999971408	16560408.23135833452121727	3913227	21	0x94494354c122aa5e29b725db58d010c5311a68df1ede6e0eac289791241497fd
750	0x0000000000000000000000000000000000000000	0x9d5eec2da0d778e96dc46562eee1cda8f28da459	1172.766	16561580.99735833452121727	3913228	0	0x922b2a60580b138e8101e222a19b42852a240eff75ebf9f70e052f09e9df93e6
751	0x0000000000000000000000000000000000000000	0x0b5a31f669dbb7a05bdf29104028f2651f2bcdd2	957.36	16562538.35735833452121727	3913229	6	0x069319d90efd37de22c88609a538f265f6f0547a30655fad18dd824b6374f8b0
752	0x0000000000000000000000000000000000000000	0x07bdd68020a16a44c0fd68c9c8557d86a743e4ff	957.36	16563495.71735833452121727	3913229	7	0x20726e179639f92202c32fe39043972241b7651e67cd2793f18833cb5e19ddb0
753	0x0000000000000000000000000000000000000000	0x71b580006ba651ee10ddbf5a0a8ba4c0ed224032	4786.8	16568282.51735833452121727	3913229	9	0xb877cec2994b6a99e8cd0c58761f865b9353a117e8febd749a4de34785e31d6e
754	0x0000000000000000000000000000000000000000	0xfdd3eac4535900d55d67754bfc5009f7d3c65f41	3.292456776	16568285.80981511052121727	3913229	11	0xb9acd636362140a83fef83f86aa2a28638bdfe7c5f39f371e9a414ba4eda1944
755	0x0000000000000000000000000000000000000000	0x1e73c1c4538685e848fd76edc2d379ad56f7219e	1340.304	16569626.11381511052121727	3913229	12	0xd33bbb1be0696bb086a31edcdc0b3e7fc8df84c8ff868e6cfe904d61f199ebdf
756	0x0000000000000000000000000000000000000000	0xb48dd5be8b4b1102731d2101da0c21b99b73f7ae	95.736	16569721.84981511052121727	3913229	19	0x9154825021e8aeb33f6ac5d5a4236b2ee5dd181708ff9ce8cc323bad05589a8a
757	0x0000000000000000000000000000000000000000	0x44061be116a5cf4c9faa9c21077a7924da9cb99a	14360.4	16584082.24981511052121727	3913229	30	0x89b30d898f01e0fd617441bc76026e05a47813b6aa6f61f41f9fb05b011cb20e
758	0x0000000000000000000000000000000000000000	0xd3232365815c9d757e6274ad30ecfb5d89ac92dd	71.802	16584154.05181511052121727	3913229	47	0x0e4f5b6666637a698ed138f74126dcee819cc02debcd3307c97318d86b7af1ef
759	0x0000000000000000000000000000000000000000	0xf4487a0a91f3c75bb9631fe6160690d9149ed853	2393.4	16586547.45181511052121727	3913229	53	0x2142f99b75ed5a770dc9b4a5be2fd09a6418b7f318ecfe660f0b0ec080925e6a
760	0x0000000000000000000000000000000000000000	0x4838021cd9031cc2aa780a0b07dfa671fcaee2b6	363.940404	16586911.39221911052121727	3913229	81	0x80c46ae1fdf6bae314d3dd5bb65ddda12d99fcc9ce42b0866de1a62e03bc0219
761	0x0000000000000000000000000000000000000000	0x4322ef8739c74fdde93c359843982d35393fd565	957.36	16587868.75221911052121727	3913229	93	0x9f865a971352cf57aa5d66b8e7679f5d93dfc1d8941055e86e2901046d4554cb
762	0x0000000000000000000000000000000000000000	0x56a331aa13c963f3f57b3e474bf68316bc42c60c	951.416364310099928808	16588820.168583420621146078	3913229	112	0xe765a266ed362305979310d8fefd0f9bd3e14d326d168c476d6e3694c9fc445f
763	0x0000000000000000000000000000000000000000	0x033724fa9c4cb645d4ed582c402c32a5eb3159a7	930.67011430452	16589750.838697725141146078	3913229	126	0x13381c7e60ef065932ea23cabd0b2874553601a3bc38b7dcf1eb46b060d775db
764	0x0000000000000000000000000000000000000000	0x2de7b408c6fdd0960c2e7966e7cfb7f3f276125c	9573.6	16599324.438697725141146078	3913231	4	0x8d24afaa8f4d0d008f5516e0af4df1776c8198fa32748a48a53c96ce23679f35
765	0x0000000000000000000000000000000000000000	0xdf1a133b44cb6ffec99550fd4708df0224d5a0a5	129.2436	16599453.682297725141146078	3913231	34	0x5069d899af1884fcbdea4f86ec0f173fc4dd1f78079e3b0104bb1fa0fdf4cc8f
766	0x0000000000000000000000000000000000000000	0x64195bdf9564ec93dcb2aa3efbdf15f18bcf2550	1914.72	16601368.402297725141146078	3913231	36	0x7be0e3bf7632cdad38c28e54e43f07214d58706325f6bbf550450af5ada0bf78
767	0x0000000000000000000000000000000000000000	0x4b90e5820fd896b286c857788e931117c8ffcbf9	21.5406	16601389.942897725141146078	3913231	45	0xcfb66b436eda6663722b3f7df70a92f04525e8e8ac341a93bf91c49c306655ed
768	0x0000000000000000000000000000000000000000	0x94594bd1d4bb56b43a56a096a914275419f192e7	15.5658526638	16601405.508750388941146078	3913231	52	0xfbcdfbf98bd74c5d02094203a8602662bf451d065e28375dbfd06892216466c3
769	0x0000000000000000000000000000000000000000	0x74f6000c416e19c8ada300eaab43690baf747d56	478.68	16601884.188750388941146078	3913233	2	0xc9c9d426a282a24759f057fc1d570d25bee33d29807c2fac5f8a972a6677a593
770	0x0000000000000000000000000000000000000000	0xd0fec9c99e3b22f47f722755edc7a44859cb9553	23934	16625818.188750388941146078	3913233	5	0x367f0d186912b81591c00e216d7f3525677a6d1a19bb06f80192909d89a44637
771	0x0000000000000000000000000000000000000000	0x992b4609935fe143891bfc7b69f18d12a87a9872	143.604	16625961.792750388941146078	3913233	7	0x9aa2d65ab13c04edb3cd184e711dbf9406ecfb336c847278b4a6d34397bd8c3f
772	0x0000000000000000000000000000000000000000	0xdd4d6963ad8ec527a0c999cccb01f63bb4cafe5c	176.15424	16626137.946990388941146078	3913233	9	0xf583c843b5f7edaa903dd045fec18d310698ceec65e28b817d94e462d4a41893
773	0x0000000000000000000000000000000000000000	0xc7857a42d78c765cbce8cbd401dbb714b9bb3dfa	239.34	16626377.286990388941146078	3913233	10	0xf71aab3687fbc6a3a05a501bbd06ca38b50219d444caed779177ffa4a0134b21
774	0x0000000000000000000000000000000000000000	0x8e465006a05f51471c5bdeb0c8fb6bb7181f06dd	2393.4	16628770.686990388941146078	3913233	16	0x72652809003c69e3b2acac3c8d511276f5f308f8e33955d94423669be37adfec
775	0x0000000000000000000000000000000000000000	0x542c0f660af41fc72b8b2088040a03da0840751f	19147.2	16647917.886990388941146078	3913233	17	0x4c0ad4e58cbcdf8140a7df9e869562a80652675699dafde8f15011e86482f728
776	0x0000000000000000000000000000000000000000	0x97122926f1bd8644be5d8800b2505028ab282234	234.5532	16648152.440190388941146078	3913233	29	0x41981e01cd2ab92db6fad56ff42faf4a4dc5f57dc9e3e54c0a859e65d16003f2
777	0x0000000000000000000000000000000000000000	0xcbe9942a5506e997e47bc86c526ea5bc090f152a	16.7538	16648169.193990388941146078	3913233	53	0x8ee99deab6947549eeef62a858bfc248b8ec0d33fdb8e930f68a5b99d4023243
778	0x0000000000000000000000000000000000000000	0x11fd440a45eb85a297c23b2ca4fd45b14c4c832a	957.36	16649126.553990388941146078	3913233	66	0xf210493e67b0a0e355b37efc8f2a33a81465d1502a367805bc28e1e090a9ad6a
779	0x0000000000000000000000000000000000000000	0xe5712d1dff0f400f3e9f13c15d74326396fc635b	622.284	16649748.837990388941146078	3913234	5	0xa3bf1ffb8776b871d1f1af51b89447c62f8a95c94588fb9e73a52dad40567ae5
780	0x0000000000000000000000000000000000000000	0x7745af1fb0b25a2137e6a60ec2508fb84206ca27	1914.72	16651663.557990388941146078	3913234	12	0x7e8e89e1347a95d22cf001b158ff1d21b7a9d3b2992da8cd37660c1c762bef1b
781	0x0000000000000000000000000000000000000000	0x920896e5679dea5fb6e4c9e7704ecf908abbea15	334.310112	16651997.868102388941146078	3913236	21	0xc14e472af4818e501636f44ab5315b8be2f6e24661cf5f315317b1b339c96707
782	0x0000000000000000000000000000000000000000	0x842ac876c6d41a1b1ece15d6167b1cccd418c8a7	2393.4	16654391.268102388941146078	3913237	6	0x5e2f12679c513cafb1a776fd6806d719757fea9ce2a446d68ee37a003909737a
783	0x0000000000000000000000000000000000000000	0xdf1718d37ed7579242ccf4f2160d09685eaa9e2f	909.492	16655300.760102388941146078	3913237	8	0x8cbcb01c4355928a41f69a83bcc815c45e0420607d19815fb7c90f5535daa33c
784	0x0000000000000000000000000000000000000000	0x0e5bed5a67f3d944eed8715d5afd3d00a10522b2	5421.524151246	16660722.284253634941146078	3913237	9	0x8dffee81b63d4f39ff8c01d3cd1ce9e7df2dfd7b43ff394e59cfb851cdd02b7b
785	0x0000000000000000000000000000000000000000	0xdbf3f1f4421429d22841c6e7cdf0618e55b86d22	478.68	16661200.964253634941146078	3913237	26	0x6fc1b94b18efa28248ec8799ec9549af37466d27b9041f0fdd40be3a31ffe4ce
786	0x0000000000000000000000000000000000000000	0x83d63bd3b58e8ab3ee0d1a72de5374fb849262e3	47.868	16661248.832253634941146078	3913237	31	0x2037cf33aef4b1e89d428973b953460719b0a8cde2c92e2787123c7cc60cea6c
787	0x0000000000000000000000000000000000000000	0xd5b9d277d8aad20697a51f76e20978996bffe055	957.36	16662206.192253634941146078	3913238	3	0xa245c2d3e6883c59d85bba4bff0f023c3e830a42d19ce6fe3a1eddc5937fa7b3
788	0x0000000000000000000000000000000000000000	0xd605391c1255bf7185143faa260681b1e15497ff	478.68	16662684.872253634941146078	3913240	25	0x5737893cbb916b7a7ee4ddde4a6ed0e64664e4315f14aa5b4d95dca163da7c05
789	0x0000000000000000000000000000000000000000	0x87f879ef10ca9ace269dc6ac8217e11c294a1aea	3350.76	16666035.632253634941146078	3913240	33	0x2993d7ae5253aa341e5e290caedb52f38d6dd02796fc95e7e0300a8f08033a98
790	0x0000000000000000000000000000000000000000	0xc2e235516e32a4167a5d69ffcebcf00a91666cb8	14.3604	16666049.992653634941146078	3913241	5	0xb3beb5ad6cd234c4ac81d17046d75042d118e502c256d411f4522fb3235278d6
791	0x0000000000000000000000000000000000000000	0x23bd56f5f8f9dec5a071cbf9bd3908dbe31bacff	95.736	16666145.728653634941146078	3913242	2	0x5a04ab96ed247ec9c92eda980bab7bd192708008a5c763fad5f6ba7172fa5b8d
792	0x0000000000000000000000000000000000000000	0xb33ee0032f0afd1bc7d197ef54ed1b6c37c1c382	24.41268	16666170.141333634941146078	3913242	15	0x984b6529d3dfcb917bb16e5a46a5c3e026a4c8c8c18e6501152e93ee63b17ec7
793	0x0000000000000000000000000000000000000000	0x4d811394afbd306204633fceb6364f4a0a05cd87	29678.16	16695848.301333634941146078	3913242	25	0x053fb03ae818cb66690cb1abb50d1640da301d57a7c3fc2cc6a989ef78b3220b
794	0x0000000000000000000000000000000000000000	0x652826b70516567358907b474a42baec0363f01c	478.68	16696326.981333634941146078	3913242	33	0x7e8b696c38a4defa2edd16d2c6fc16a7fab40455e054115bd63ba1104724aba1
795	0x0000000000000000000000000000000000000000	0xbcd27c9611784997df4dcf9415e8369035fe98ea	1005.228	16697332.209333634941146078	3913242	45	0x3f233ffbba01e7420bd52bfa13b320b046b6aac8a6d469c34c26ea56d35fc19e
796	0x0000000000000000000000000000000000000000	0xbc13a9ed082cc1556a92d05a143fcd2346ebe62c	957.36	16698289.569333634941146078	3913242	60	0xea31197d2dbd78e3265b9a6b57cde9b52906fe70ba9d08d41b2cc6121c532727
797	0x0000000000000000000000000000000000000000	0xac9655475b896493ffc4cc12008d51af15143945	205.8324	16698495.401733634941146078	3913242	67	0x8c8653dfa3f6834402058c4d66947312fd77350420026f39679ae52df2266824
798	0x0000000000000000000000000000000000000000	0x83d63bd3b58e8ab3ee0d1a72de5374fb849262e3	430.812	16698926.213733634941146078	3913242	75	0xa2adf255a65cf00cbf26a1f8d23c959180c84f13d29ac89cf4d537a966cb6aab
799	0x0000000000000000000000000000000000000000	0xea56152d94d6dc1d69c90e1bb4a2ef8c79d4d49d	1124.898	16700051.111733634941146078	3913243	135	0x3cb21075540b57397e0270805ec26fee81e5a62ff47c162e701431b545b62935
800	0x0000000000000000000000000000000000000000	0x1a289ac97e66ee027c0a1ec59b34807e67365068	263.274	16700314.385733634941146078	3913243	136	0xc1b1841543a8bfe637baf5cb3407944fdac5029d948f4448e6fabd8b965e941d
801	0x0000000000000000000000000000000000000000	0xc6b54215900b1ce470a8e895e55c6575d2ce888e	1579.644	16701894.029733634941146078	3913243	148	0x476bf5b195de2b955fb54eb37a0ccc4d8021745a9529a775ec19663a51212060
802	0x0000000000000000000000000000000000000000	0x938afa1702f8b78becab440629a503f8c7b4a79a	5265.48	16707159.509733634941146078	3913244	2	0xe73ef8324555bf7df638a97eb82954216d62cc8f9119c437758270420c4f75c5
803	0x0000000000000000000000000000000000000000	0x809c51e868c3977139e13cb99333eaa0e7915bdb	1436.04	16708595.549733634941146078	3913244	8	0x3d157b6890cc8b3841d96b59554210e85918e0f80308b2064ea938fcc1512318
804	0x0000000000000000000000000000000000000000	0x0f934a2123a2b510522590599eb9bec66c89e64b	955.004032776	16709550.553766410941146078	3913244	9	0xa2b7af37814b218283bf405322862ca0588aaafc0a81410d3fa922bb7250634a
805	0x0000000000000000000000000000000000000000	0x26289f1da31c1c480e542b2a1ba639385d3cd9eb	478.68	16710029.233766410941146078	3913244	19	0xb71bce072eec15a32b81b3d94ae105580ca91e33361c952ea80786cb57f53be9
806	0x0000000000000000000000000000000000000000	0xc32548ea1e08877dfaf9a4e8fb55acfcdb042849	67.0152	16710096.248966410941146078	3913244	24	0x2d979fcc37730857c9b467ac54b90fc0110f960d8e3c1c0faf2993c4819ad1bb
807	0x0000000000000000000000000000000000000000	0x4e2dd5be11ff00715c57e53825bfc628901d1d6b	253.556796	16710349.805762410941146078	3913244	37	0x089c26d28e65ed0da4a666d676cfc7c100e094b1f6c3db59608cd87db783f043
808	0x0000000000000000000000000000000000000000	0x7947168b6bd43f07ef745a3b0715d051f29c489b	5744.16	16716093.965762410941146078	3913244	47	0x38718ef938e6b73f5444b8479302b408d284abedfa76bdd74e0be7f6b8ff4a92
809	0x0000000000000000000000000000000000000000	0x7d86fef6d9423e4c52f4daa476c87a3761025da0	43.0812	16716137.046962410941146078	3913244	51	0x451dac281c06184e542839fd91269a3b8cd6bae5e3a5bb0d84543cc55f2ee3e5
810	0x0000000000000000000000000000000000000000	0x31fd36d29201d5d5f276989626af2b15b11ba520	478.68	16716615.726962410941146078	3913244	91	0xfc08a22160725fa93f0c6d1b2f22515e473a1e8f6cb31b3dbcb290957d87fa39
811	0x0000000000000000000000000000000000000000	0x284e56161f159cfa4fa1d9101ec60014178b470e	8616.24	16725231.966962410941146078	3913244	95	0x0e171cefee3bc794b2678b850a1a54e47dd34259af1185f2a2029d423413de11
812	0x0000000000000000000000000000000000000000	0x3358da991838e8042b2363f2dfcef1edf48544e2	3829.44	16729061.406962410941146078	3913244	97	0x14348a5071968f2c3a439ed5ca921bbb3d0d8cc6b14f5c6286d953b065a118a2
813	0x0000000000000000000000000000000000000000	0xe64fdfbaabfa221da2217e526219aa856e6b9f17	287.208	16729348.614962410941146078	3913245	22	0x4a680880d89148f23fb30014d5cbb731d17a849461eca231f3369fd74aa67723
814	0x0000000000000000000000000000000000000000	0xcac0eb798903ffe73ab1776da3174e6e40e721c6	244.1268	16729592.741762410941146078	3913245	24	0x4e69376664ac2f1425ee7db1cab716a9a3c1e5fc241a53b38f3b098765059b5c
815	0x0000000000000000000000000000000000000000	0x0f00b1bb94d807959499e4ec372d3f9102d825cf	4786.8	16734379.541762410941146078	3913245	28	0x5df327434393b9f719d9f6e3d339e974864a0654f9c086befb3bfd9366e4de02
816	0x0000000000000000000000000000000000000000	0xe16bb6525a51ecd86691839f6719fc3ae4d741c5	718.02	16735097.561762410941146078	3913245	42	0xebe6ac62408ef89c6079691246e3bc437a16d204d6aca0c816251a9714c60f84
817	0x0000000000000000000000000000000000000000	0x4d454f48989a2397b680568139e1aed25c0f649e	119.67	16735217.231762410941146078	3913247	1	0xf22e733b6e34d160181ad28d30768e6bd695a54cf78f04866bc2a7efe39511c1
818	0x0000000000000000000000000000000000000000	0x8aae50113d811edf6653ee28a779cdbd2a783707	387.7308	16735604.962562410941146078	3913247	7	0x517aba792f0586b15a3b51ec23ff0bfc6411c8f08c3dae9481e3d9b02ade396c
819	0x0000000000000000000000000000000000000000	0xf57d20cc6d7c3f2a91e451f13a2b811cb06ba7cb	167.538	16735772.500562410941146078	3913250	12	0xca9c3d5219f668ddf7f3325acf801318052f44f4f9a6f7a3ae4431ba1493bc2e
820	0x0000000000000000000000000000000000000000	0xcaaeeede9516034796a889625013bb643c9f962e	957.36	16736729.860562410941146078	3913250	13	0xc5b46e0f395c89b38b0e17b04546a9917fa59da12706a1c711806a623f43d7da
821	0x0000000000000000000000000000000000000000	0x81334fbd096c9f293610ef7850aac20632dd5c8d	1436.04	16738165.900562410941146078	3913250	35	0x12a41ac4c0cd8959299412bc5a88ea4ce5fb1eb56060b9b41440732755fb47bc
822	0x0000000000000000000000000000000000000000	0x1e5098e2557262ba48676cf020545c331264e95d	957.36	16739123.260562410941146078	3913251	8	0xa263993cce12be1904ef223d1dd8ab36c86f494e129e4a235e96bbec71f3533c
823	0x0000000000000000000000000000000000000000	0xec5f23f8afb7ec07acaf312f68f177c1a377c962	47.868	16739171.128562410941146078	3913252	32	0x0b30dcced9d1b5181e27b1abf73bc40701e4e4b2ea593649d9971b9e96f7e527
824	0x0000000000000000000000000000000000000000	0xd83fda2febcaacf9da132482931d343bbca0c7cb	4786.8	16743957.928562410941146078	3913252	33	0xdd8c6431153ea94c877c6bc91e3842cdad622a9154f24d70d8e39ffbda986fb8
825	0x0000000000000000000000000000000000000000	0x845c715762b8e7d9371c7ab7b649e19ba11cc5ab	9573.6	16753531.528562410941146078	3913253	44	0x89885b67433fec9811ddf2da85c7f1f73e8572d1e3e0ee292828af32e256cb5c
826	0x0000000000000000000000000000000000000000	0x920896e5679dea5fb6e4c9e7704ecf908abbea15	334.310112	16753865.838674410941146078	3913253	46	0xe093397b16f72d335b8fcd511bc68bf1c46c1d87c080476348bacfd0139cde09
827	0x0000000000000000000000000000000000000000	0x4fcca3566eb1fc3650486c36f738effbb124daba	43.0812	16753908.919874410941146078	3913255	0	0xdf0fcb7c0f7889321f1f27c97c1a9e8231bed23097ff4937875fa2fbc9960f4d
828	0x0000000000000000000000000000000000000000	0x7453697ff21968ebe745f65b9e065da3c246ca26	7180.2	16761089.119874410941146078	3913255	1	0xdd7f4d0c6b8b95ee4459377b8726b55dcd05f0637017dfb7c17b9c3a948b4b3a
829	0x0000000000000000000000000000000000000000	0x6e0373701cca4ec22257949e9a6bbcdfa18fda33	3829.44	16764918.559874410941146078	3913255	2	0xfc1955dbf71ea452946e25ac9b3c8eaaa0b6bd4659bf9d152393b914ee52f43d
830	0x0000000000000000000000000000000000000000	0x2ecbb905fe50b0a372d9060187a3c4b98f2d5254	2872.08	16767790.639874410941146078	3913255	36	0xc341dabfb57029187909e19012725479059b8b2fb099eec463aaca732fe22e21
831	0x0000000000000000000000000000000000000000	0xea83cd066c97217a80adac64d662680c1bf1453a	715.12087458	16768505.760748990941146078	3913255	37	0x283cd33bd99d3d5ba3d801336bc0d40afa1a3b993163488ed773b37212c6d4cd
832	0x0000000000000000000000000000000000000000	0xc9fbafea79ddb4650a12a0582b830d1d483003a7	4966.78368	16773472.544428990941146078	3913255	40	0xa57fd52d6cbce32d7cc83872e87163288aec7b6bb7a31600f46fa9f56ac8b152
833	0x0000000000000000000000000000000000000000	0x0f65a370db1ca06fb190409ec877f67e87628aed	1177.5528	16774650.097228990941146078	3913256	9	0x52b4ed8b4707d450f2a9d6ca44a5cabb85f68018451f834ee24f9882d34b2e96
834	0x0000000000000000000000000000000000000000	0xb2adaf8820f076ce8f160544988461288732abdd	47.868	16774697.965228990941146078	3913256	13	0x59de2b4fc1be0999cc080a524f534da55f6dd7788c66af5f0bdb4bfe652f7bf0
835	0x0000000000000000000000000000000000000000	0xe8b3a424b0ea3528197083beade96af518b7b950	143.604	16774841.569228990941146078	3913258	38	0x7f839c6a184e38af69f2160493379852f487eba63efdb598728e6cc0516c12c6
836	0x0000000000000000000000000000000000000000	0x457485b5e312bdd809e94218915694dc6f092c95	478.68	16775320.249228990941146078	3913258	45	0x73ec6936d238612bf2ce1aaf137a463152d68aa119f27fcf6487b75e8b71984c
837	0x0000000000000000000000000000000000000000	0x5e01e279cfcd3d14c0bfdc88fc65619379f3c579	2393.4	16777713.649228990941146078	3913258	46	0x4789814c74242b06054a75b0fdfd7352863f82e22c076dc5a73b33924922a02e
838	0x0000000000000000000000000000000000000000	0x3a97f0d752b8c0b6b8d3d1211af1a4d639ceab0e	143.604	16777857.253228990941146078	3913258	66	0x2e944400400d7025d0369a5839147fa4663646620a2200295b6672e065c70c9e
839	0x0000000000000000000000000000000000000000	0xfbfb0f3baffd71f31bbdfb21a070b3e2419c9ae7	239.34	16778096.593228990941146078	3913259	2	0xa561e30642b3805a92c577f5bf3356d87ea6f78a29df009ecc28aabc6362b0ba
840	0x0000000000000000000000000000000000000000	0xc6b54215900b1ce470a8e895e55c6575d2ce888e	430.812	16778527.405228990941146078	3913259	7	0x5295f8290a434b4d1e6d37d066ef3e080d0566a50995b8dabaa65e38782888fb
841	0x0000000000000000000000000000000000000000	0xac80e23a6c04faa9775e61f324920c358040a773	1436.04	16779963.445228990941146078	3913259	13	0xda99f69f749ee684d516203509bce75fdeeb991487f3f14c7aab8ab1a53c5d55
842	0x0000000000000000000000000000000000000000	0x4b90e5820fd896b286c857788e931117c8ffcbf9	382.944	16780346.389228990941146078	3913259	48	0x04ff90bc9ba2ccad027962e3c854f6ef09722e62d101988ee512335a14210ea9
843	0x0000000000000000000000000000000000000000	0xd93276ac7a6b763c1eca9c72bb40d7e34b38df8c	1914.72	16782261.109228990941146078	3913259	52	0x56df6b852d68114f173f0fe9d40e4d1ce4648233dbda9dd942f022c055505e6f
844	0x0000000000000000000000000000000000000000	0x0f00b1bb94d807959499e4ec372d3f9102d825cf	9573.6	16791834.709228990941146078	3913259	56	0xa79344e53dda187d026ad797d2e755a863d49e8b582b1073cc2751f1990a9beb
845	0x0000000000000000000000000000000000000000	0xf0397962033ea568c4597eb221c0559867a6ece0	488.2536	16792322.962828990941146078	3913259	58	0xc652e01247a068da880652abfed5b0ca74b0323e236b2cd885c7c46458d6a351
846	0x0000000000000000000000000000000000000000	0xd9d8d952f697a8bd9eee03c3e922f3fa4495f1d5	382.944	16792705.906828990941146078	3913259	60	0xf07f6b7e1922920f880546010b40872299242798886dc23880618efdc8751776
847	0x0000000000000000000000000000000000000000	0x9eb429cb38ad55553a6e83ccacd178c7fd27a26a	4786.8	16797492.706828990941146078	3913261	2	0x0174afed6927e7b1c3e4c9a172c76e888f6829a2e0e4f5e16801fd5ded15ebc6
848	0x0000000000000000000000000000000000000000	0x833a2d3568be2582b31577a3d01a6fe0ca2f0258	9573.6	16807066.306828990941146078	3913261	7	0xe0b9f21372893434fe86107a9e5dcca2ad323712d21df096b9772752661e40c1
849	0x0000000000000000000000000000000000000000	0x73b6eba1b970b2e14c62be9dc948c333b2d6f764	291.9948	16807358.301628990941146078	3913262	22	0x4ed8128be8e2e193a97f4a3fb9e6ccd524c0ed1c909a96a12838f63a7eacbb47
850	0x0000000000000000000000000000000000000000	0xdf0beecd6efd2c07f8b5295ba7b4284fd6a484e4	718.02	16808076.321628990941146078	3913264	3	0x49dfab959119df7fdad16e48f0bfc7287211ff33c8d6a24d12c880523ac61dd7
851	0x0000000000000000000000000000000000000000	0x7b473bd1b1e1e293241da5fff13f947d9e5c588d	1436.04	16809512.361628990941146078	3913264	41	0xbaf94799a082a51f344956cc9f3223cb815aaf7a3dfed599868e6886f55074e9
852	0x0000000000000000000000000000000000000000	0xc8a97249ed2ec092b1ee9e161f86e08970fe7426	143.604	16809655.965628990941146078	3913264	44	0x1a5970eeaf21749f1de8102cce08eb3d8c4c9caa96c7a9dfd65894e1e84faec9
853	0x0000000000000000000000000000000000000000	0x00721ee8954c5abd6359fb79b407549181d4b5fd	4308.12	16813964.085628990941146078	3913264	45	0xe11fd3f85382bb7c1c9d41e6ffc906a2aeadd1486a4fef7478c8c2b66b6494da
854	0x0000000000000000000000000000000000000000	0x920fabda5f936595fad51904dd8ca103fc005fe1	14360.4	16828324.485628990941146078	3913264	54	0xc077b01139ee42afc7f525a42612ff3311fbf38c2291818c0c8267649bf57ec9
855	0x0000000000000000000000000000000000000000	0xc32548ea1e08877dfaf9a4e8fb55acfcdb042849	191.472	16828515.957628990941146078	3913265	4	0x2c9034ef2d8d1f677485f2152ada52a911b6e520bcf5e5aeceaf36f42bcf8d33
856	0x0000000000000000000000000000000000000000	0x85c1fee60f98b7de104179e29c5fde2c1166bdc5	7180.2	16835696.157628990941146078	3913265	6	0xf55e3d2a6c3b60764f3252f5380efcdb1502331a1623c454007965ed9d7a5d38
857	0x0000000000000000000000000000000000000000	0x8aae50113d811edf6653ee28a779cdbd2a783707	473.41452	16836169.572148990941146078	3913265	20	0x1a94ef8bb6f6abac1831787cb6218887451a5ae3060c42e72089718c8f077c0d
858	0x0000000000000000000000000000000000000000	0x89a61a6d6eb95f56da5bb2f5e879a569d85967ef	3829.44	16839999.012148990941146078	3913265	39	0x67d8cea8ce2ecb7dbe85fbb8eb20ec9bce3cdf26f48f9ca425785d1667a649d1
859	0x0000000000000000000000000000000000000000	0xa96a22f9e444f71e26747da0d902d12049741797	23934	16863933.012148990941146078	3913265	44	0x78d3406e80945fa34e82bbd7ba4d20a3e6b0869dc83a4fd9f42e8af5c9a28707
860	0x0000000000000000000000000000000000000000	0xbb76da4426b73f2797192b7318ddb07ab1b95a47	923.8524	16864856.864548990941146078	3913265	51	0x97e996605ffb9db8e70637ea257ed72e9dc4e02e4ee1a72eb4ecd3b47b2b0b1d
861	0x0000000000000000000000000000000000000000	0x26c55490f82471f14cb9ba05cb42570823f3d281	71.802	16864928.666548990941146078	3913265	59	0xafb9f6d375829c57588aef207fa0fa8d5c716c26221e4e1b7a1f5f5c3bd3b751
862	0x0000000000000000000000000000000000000000	0xf9f1088358b4c7e7e779988476aa3d71c40e1054	138.8172	16865067.483748990941146078	3913265	88	0x638e873b01a6374b70d64f35b9d3a05ac67c31533e6c668bdc12c29eebcce20e
863	0x0000000000000000000000000000000000000000	0x130ae18ed38c4f8523e6b47ff701a1382bdb9cec	2393.4	16867460.883748990941146078	3913265	92	0xa304af3592f9737cbe70073b7ed18a184db9df140896715d654bc6e6420d505b
864	0x0000000000000000000000000000000000000000	0x1f29c0df02fd6792191c1d42b234f67c51600e0b	2058.324	16869519.207748990941146078	3913266	2	0x13b7152e640ad2b1eb59f3a64e84ec6eaf8619358b3b46b714b4c4e8c039d19a
865	0x0000000000000000000000000000000000000000	0x33eecd164396c1cbd8cac43571b85fd2718b637f	23934	16893453.207748990941146078	3913268	43	0xb04ebecd988f83c178a0b0613f20680645f62b683a04adff5f8b684c1a803f1b
866	0x0000000000000000000000000000000000000000	0xc26529ca42c2e4339f73b45b5e561a32ee473a4e	957.36	16894410.567748990941146078	3913268	45	0x6422bd7076ff9a5c67d9052dcb905da4c2a0dd2b3749358c6758cc5064efec86
867	0x0000000000000000000000000000000000000000	0x63f87deb3d28d931396a021fc860bfc6a93e77d5	519.4537757148	16894930.021524705741146078	3913268	46	0x113e9b7bf68ac3e234777db65f3f9fbf4f9e41ba984b7996e8f2ae30f69c2e8e
868	0x0000000000000000000000000000000000000000	0x4e08e3ad6d6abe1b8df4b3dc691204d45fe3bd01	478.68	16895408.701524705741146078	3913268	47	0xf144608e94ed189d09b8f5f66e94113d849c1545c1829b64c216df1308586197
869	0x0000000000000000000000000000000000000000	0x1eaf87c79092b92121d5149f4683558c522b1ec7	478.68	16895887.381524705741146078	3913268	48	0x250dfae7441cade07b3545e87d6bcd336b7bdd160dd999fc4e7e968fee06c90e
870	0x0000000000000000000000000000000000000000	0x00c84932ae17002220a6a65b8aad00c4c207110b	478.68	16896366.061524705741146078	3913268	49	0x9b62db93fd57c1eab432b8295a0dc3a065d092745451b8302e2f288724a7f830
871	0x0000000000000000000000000000000000000000	0x71b580006ba651ee10ddbf5a0a8ba4c0ed224032	7180.2	16903546.261524705741146078	3913268	50	0x74b9d6f03d165246022b7bd2eda5d1a72deced4932f950518b376e913b84bfa8
872	0x0000000000000000000000000000000000000000	0x90bb44ee2e9afebe694874f184eb11a917cbdea6	77.3881956	16903623.649720305741146078	3913268	52	0x89a23ca6769e0d76ab9ddd0779d81162efed3defbdbfbcee6a66c4c0db44533f
873	0x0000000000000000000000000000000000000000	0xceceb9d581b900f37d23d6239802db9d02760691	38.2944	16903661.944120305741146078	3913268	53	0x7220b6cefe9d1f0c2d4775bb1e1ef87329952f792ff40a1405fb8d8808d1e0c3
874	0x0000000000000000000000000000000000000000	0x26289f1da31c1c480e542b2a1ba639385d3cd9eb	478.68	16904140.624120305741146078	3913268	60	0xdf2816de66bfb54680745627ff26a3ee4ebe2b30422f1b35c02324d72c30ed7f
875	0x0000000000000000000000000000000000000000	0x008daefb4d9c84b6cdab9a0704b77e5ec3a5b034	1340.304	16905480.928120305741146078	3913269	0	0x89f2ca57ad13c3fc8bf7730fc65e0e8ffcf69a414307a234fcbac7d2ae143e8c
876	0x0000000000000000000000000000000000000000	0x75fabfe2063c9d577838442c97e24369d2c42977	957.36	16906438.288120305741146078	3913269	2	0x895ce7ef6be049471405be3c5926b4c1482fff21e71b439ba321aab85a6c04e3
877	0x0000000000000000000000000000000000000000	0x64984387800e7d671afd64f8703e7f414430819d	287.208	16906725.496120305741146078	3913269	13	0x02e251a2cdc4d00e607517ea0f548f411bae3eb432a9e4d156a65553859de33f
878	0x0000000000000000000000000000000000000000	0xce2a58cd355405593ca381c149f123d1a98abe37	478.68	16907204.176120305741146078	3913269	14	0x3c2230c6721a6deeee57ba7b2f3c203f23d05e492640076467d814585fb24862
879	0x0000000000000000000000000000000000000000	0xb063826168f3d860128a89ff88f5b2de1c9a188b	2393.4	16909597.576120305741146078	3913269	15	0xaee4843aaf6eed908364d75bdfcd12d3b77129dd037e36d5d74896888682327f
880	0x0000000000000000000000000000000000000000	0x858f8750f53b11ed9ce63e9e14b1d1fdfe6740e7	478.68	16910076.256120305741146078	3913269	29	0xa017f536409cee9ef29aa11f3d77afccdae71862762285cc7aea5132bf156d54
881	0x0000000000000000000000000000000000000000	0x65a1a9031c4c7c432814848f50933f3f50a7152c	9573.6	16919649.856120305741146078	3913269	33	0xd3569eace57f91e541fe888478df00aa27e96aaac79ec45dde321de69315e3f4
882	0x0000000000000000000000000000000000000000	0x85c1fee60f98b7de104179e29c5fde2c1166bdc5	1818.984	16921468.840120305741146078	3913269	42	0xbb9eaae51065f8f3cd6817cf917be952a625a73296284a2b6a66e90367919ead
883	0x0000000000000000000000000000000000000000	0x5e1226a66cdb40db52585f447519f9e061058e95	523.6651353396	16921992.505255645341146078	3913269	53	0x3ae5550e7d4e00237e83ff9b3c4fd767c2d40d648e614f20fa4a32c211783a65
884	0x0000000000000000000000000000000000000000	0x181c135605ac5f33c0ea1c273680efe0572c5398	1436.04	16923428.545255645341146078	3913269	72	0x8d65cdedb2583beab06e93f9bcf7439e44bbcf66799bad667f755a89bc35fa7f
885	0x0000000000000000000000000000000000000000	0x880900c66a494893117110fe129e5705a16ab9a1	1436.04	16924864.585255645341146078	3913269	78	0xc632499b28a67b3097ab71e18f783ba85e41657db2d8611f1f93e5188b797bf5
886	0x0000000000000000000000000000000000000000	0x0d6e6e935b63c01c5ada029f3cae5f7fa48d34a7	79.8454467252	16924944.430702370541146078	3913271	2	0xe065b6f5758412212452202a6772cddaeeec766084ba46cc7caffcf1c6e9e6bf
887	0x0000000000000000000000000000000000000000	0x9b14c4c9874c61977d45b89f24cbd8e3eb9dba07	95.736	16925040.166702370541146078	3913271	34	0xf103df26810366f95502ebe2d688be548e41ecaec195d2b2ace1b071bdea973c
888	0x0000000000000000000000000000000000000000	0xdfae8b940186f12be4f19a0cc75bcf666a4238aa	11.00964	16925051.176342370541146078	3913271	37	0xf907eb36413f3c7cfddc54a49d5c703a8a8aea688a6cd66c07f16b824981a044
889	0x0000000000000000000000000000000000000000	0x90b7f3c8b5bc246404a9d6dc7aaa8d30a93414f3	909.492	16925960.668342370541146078	3913272	11	0x722fe01997749411d1456275790dc57bb2786cb0ec9d00ea99833a0947b7e994
890	0x0000000000000000000000000000000000000000	0xf913694a348d35840228a8978aa8cfdf69fff75c	7446.58542	16933407.253762370541146078	3913272	18	0x4929d84a6fb70db8877df15557baf123ad61e9327a7c1ea19cded5b74db708bd
891	0x0000000000000000000000000000000000000000	0x5cdb931930464c2c354f5c2c9627997a8f04e160	2.3934	16933409.647162370541146078	3913272	35	0xc6283e26e1403c9974bdcdf380930081f763b4b4aefba3d3d5a9bfbead58529f
892	0x0000000000000000000000000000000000000000	0x1b4595c80fa0006b1eaaf47e77b01fa7919c5ddc	71.802	16933481.449162370541146078	3913273	20	0xeac057f7e4367abe49d96b997a9e2077e91fe3108b7822f759a8e9874e0076d0
893	0x0000000000000000000000000000000000000000	0xba28c1b409664c0893a090d637a027e4162a41bc	16275.12	16949756.569162370541146078	3913273	21	0x3c99b49c928a134d031b9f047daac9f69f66f9c9ceb4b76368b4fddf36e0a528
894	0x0000000000000000000000000000000000000000	0xa6a3c95dd7d3edafca3e90b582990fafdf572a82	196.2588	16949952.827962370541146078	3913273	28	0xbdd7096d56cacebde162e0d120f5b1898daedc7c08760e4dba44b28a9612b68e
895	0x0000000000000000000000000000000000000000	0x01a3373d40335bccd4bd6e5ea864da5ac4e54e9f	4786.8	16954739.627962370541146078	3913273	32	0x74d367b8a156cb5a79c7f3bc8ff82503254fe5e6097bb80bdf0d943a65563a39
896	0x0000000000000000000000000000000000000000	0x224fa2143b862306b7fd8f5bd6788e9207c68e4f	62.2284	16954801.856362370541146078	3913275	2	0x47766a40d5a9325b791d24617a48c30dd27c6d3b1ce904d56043fe4479ee44bf
897	0x0000000000000000000000000000000000000000	0x62386a2fc0b7dffa79260b1494c0cd459c94d7f2	129.2436	16954931.099962370541146078	3913275	19	0x7dbfdb24a9c78982d76ac7f7f105429baf2cb08a356e2876e7939192170b1e54
898	0x0000000000000000000000000000000000000000	0x167464f95479c402bfba7a254a9bd75064f8d05f	478.68	16955409.779962370541146078	3913275	33	0xc1e19ee9aff34fe87d9684b20c610d72f36afd9d91cc1e33009a66272b171ade
899	0x0000000000000000000000000000000000000000	0xd83fda2febcaacf9da132482931d343bbca0c7cb	4786.8	16960196.579962370541146078	3913276	6	0xee176bc46b7f5a504c72917004f1e9d14a1b48b68337305daa8496587dbf1bfb
900	0x0000000000000000000000000000000000000000	0x9088365e761bed4edaaa97af57ec1cd2700c6fd1	478.68	16960675.259962370541146078	3913276	14	0x9e20df65026df5ef8daa223b9cc1e96c9bf5e8f6cef92b7165e0773ca783290f
901	0x0000000000000000000000000000000000000000	0xb62ceddd473ccabcfa8dfb8871171619397ae0bc	239.34	16960914.599962370541146078	3913277	31	0x036b8ce93650ec15e7ca719eef0781710e69287580120312664276f58e399e59
902	0x0000000000000000000000000000000000000000	0x880b0dc7386f302304b752c5a52535a6c9d9d91e	1436.04	16962350.639962370541146078	3913280	5	0x902bed8d177f2a8396eed0e7caa46f1e1555d0898cdaf94b3606b66835b31093
903	0x0000000000000000000000000000000000000000	0x1552f4d3e5b5d0cffc14009ad28fec9c2e0d768a	478.68	16962829.319962370541146078	3913281	25	0x29d26b44dfc3e9b15e5b8507fdec2cb20e224957a91559a39528486775fff700
904	0x0000000000000000000000000000000000000000	0xdc7477856d9d73e4a5f2f37ea144a593513a73a4	86.1624	16962915.482362370541146078	3913281	27	0x0bdf92d64ce8e8c161f685d5ae0eb3ac80a1a4f4608609f14a5cb247af6eb56f
905	0x0000000000000000000000000000000000000000	0x820910798bdb9b7885bfb7cf9bb37c70fd67e21a	2393.4	16965308.882362370541146078	3913282	1	0x7f46024d2b17dc261d3ae90b0b0c9351c8723c18499c24a8e9ce97ff879631cb
906	0x0000000000000000000000000000000000000000	0xf88150ae0ed2c6959494335f7cd2285396a2f2d6	95.736	16965404.618362370541146078	3913282	3	0x21167a98da674a3e15b7504caf6aa20a27d30988533f2095dacd260d6a0bd526
907	0x0000000000000000000000000000000000000000	0x33ee02272a72196607d43771b4f86bdb38853808	478.68	16965883.298362370541146078	3913282	7	0xb4fd564dc1b46fdb1b4207061eccbf72eeb5104706cbf8ec6b9f445ce5793686
908	0x0000000000000000000000000000000000000000	0x683d7d8536b67dce9fa2f3d2b64eaa2969d8cfc6	1005.228	16966888.526362370541146078	3913282	13	0xe1f7023b2c3b9e06adb372fc7670eabef01060247e6f88225812ea5ccd14138d
909	0x0000000000000000000000000000000000000000	0x190430f2c396774b1c21b987f936eac97b478017	478.68	16967367.206362370541146078	3913282	32	0x796b6d694a61cbe76aed8439d9f7d9604cc1954e0a8c60cbdf5572d32dee6dcc
910	0x0000000000000000000000000000000000000000	0x0060d4c4ff6ca6420de5b474fba93cbd81da3d25	23.934	16967391.140362370541146078	3913282	33	0x79808ec7124ad26ded7d541adb47183ba3437b200feab67d22c4b5dd4bbf4a55
911	0x0000000000000000000000000000000000000000	0x00bd192ae02d2e66df15b4dbbb8355d3f94c268d	47.868	16967439.008362370541146078	3913282	69	0xa64905f9976ceaa29cbc325e07b417ab8d4847516e37a12d5ecece25238a0459
912	0x0000000000000000000000000000000000000000	0x88e305d2a62dd19366b0ee5c731c23e2709419b8	191.472	16967630.480362370541146078	3913283	20	0xe8e99fe1cf6791be6c5b4e0064df22102660243be9c9b3fbb050c058754c4ba6
913	0x0000000000000000000000000000000000000000	0x7a244594bf307a96e8f103ec00501c2cd430989a	397.3044	16968027.784762370541146078	3913284	31	0xda58b889ee2e3ec4ac173eea45b2fd17c834017b483acd92318cf41c3bb59e07
914	0x0000000000000000000000000000000000000000	0x5d1207c231795284bed373bb5da22e8a2e31e291	57.4416	16968085.226362370541146078	3913284	43	0x9388b113433ab3e014fc7682497cd9b94bb236e3dc6e2bd65213326767f787e1
915	0x0000000000000000000000000000000000000000	0x38b2197106123387a0d4de368431a8bacdda30e2	4786.8	16972872.026362370541146078	3913284	48	0x654a5613e4b23e0bb000138c602ea37286a25dc9c5b0ca75c036dddf05f95711
916	0x0000000000000000000000000000000000000000	0xd52f455de23cc4f1a7cc98ccdc018090f220bfd4	4786.8	16977658.826362370541146078	3913285	7	0xa45488cb5489aafc39a84726602ea5070089bfcf288909128f6de549e6f13600
917	0x0000000000000000000000000000000000000000	0xd8b1ebc8dab48c2a12f9f9e16d9eb7d125d39cfe	957.36	16978616.186362370541146078	3913286	44	0x617a741b20d09d7e555ac6a2c2bf21adbbeda7dda5b46e224f380c23e28bce3d
918	0x0000000000000000000000000000000000000000	0x9088365e761bed4edaaa97af57ec1cd2700c6fd1	440.3856	16979056.571962370541146078	3913286	51	0x995249240f9fedb2456b5d6242a6b44e2968dab314bbc7a053898b7d7bb65d97
919	0x0000000000000000000000000000000000000000	0xf766d2eaf5392b862d80e5d4dc7786b7f5ed1a99	239.34	16979295.911962370541146078	3913286	70	0xf971ddc86a52a8de8f816a4c6e837e096b301aa127f01223c45decc6d3e95638
920	0x0000000000000000000000000000000000000000	0x55ead4722ed057c5b888dfd7c60a2f01666d47b9	239.34	16979535.251962370541146078	3913286	87	0xa9b82491d9586170a1cf3ca6f58a2ad66787e61f854cc09137781d5063cea4f0
921	0x0000000000000000000000000000000000000000	0x00bd192ae02d2e66df15b4dbbb8355d3f94c268d	957.36	16980492.611962370541146078	3913286	91	0xc5d898ab1c3303e9d1f6e2e2345eaf17de4fdb8d52c1b04cc035cdb40314e045
922	0x0000000000000000000000000000000000000000	0x7773a99f1de220e8db576b699d29c4c24328f715	478.68	16980971.291962370541146078	3913287	84	0x6aac89966d1f43639042d2177a72bcb95dd4b1c20e2c1790c4d05ce26011df0b
923	0x0000000000000000000000000000000000000000	0x5865a2f1ccd1c0c6a97e5b0b3f0e19b1cf8a728b	2393.4	16983364.691962370541146078	3913287	108	0xdfbc4b5c5f4b70da65bd7d56f5919fe264c149deeb59bddcd0d64e0d40278fce
924	0x0000000000000000000000000000000000000000	0x4a1fc05b163ed6cfbc1bf8838b968ec87d1beb07	478.68	16983843.371962370541146078	3913287	109	0xebff1de85883cd6e351d968590f4494d44656966eb03528acb52dbaca3f3802d
925	0x0000000000000000000000000000000000000000	0xf27ebe9eb1fd582e31d6dd979b293002a2c11f60	478.68	16984322.051962370541146078	3913287	114	0x03b87a5dcee2b81b58e7dbb42af84001f842c3aeed13a5b36adac997265176be
926	0x0000000000000000000000000000000000000000	0xc59ffcf205976e2016b34203fc2214a5db98558d	2106.192	16986428.243962370541146078	3913287	118	0x9a39293e62fa9590af314a48f1341ea351087b2185cf226922dfa1d323aab0e2
927	0x0000000000000000000000000000000000000000	0x5eca13dc5a1653666d009601f0675d0aa53a2d0b	4.7868	16986433.030762370541146078	3913287	130	0xb3bbdc1313cda2aa0f7f1b9d489f1083cfb08e78348a6c9944845f799f25f82c
928	0x0000000000000000000000000000000000000000	0x22021bb4404a637cc82cbff53bd30f9c16083095	478.68	16986911.710762370541146078	3913288	1	0xec1fb08e45e90fdc42cff37c56bcde3ec9236c137635aba878b1c81373a33427
929	0x0000000000000000000000000000000000000000	0xdf1718d37ed7579242ccf4f2160d09685eaa9e2f	378.1572	16987289.867962370541146078	3913289	6	0xc6ea219bebf440df8c26924f6310a447532354ab7d8703aaa6102a94f0a9974b
930	0x0000000000000000000000000000000000000000	0xdc5ce0496db22fc533edab2c0f1177ac2f5a9795	1094.25319935216	16988384.121161722701146078	3913289	11	0xc81b952ebab98ad36eaa85f7484a278cd1cf9dd3c86910d93fa237afb6772cd0
931	0x0000000000000000000000000000000000000000	0x6132075b91fa4de329ef353813d44c741bd57765	92.86392	16988476.985081722701146078	3913289	40	0x73301f9bf81fc1876f41709dafaa2b1daf68083b6c0a46194c17cf088958f491
932	0x0000000000000000000000000000000000000000	0x54d11f3ed39444920b01c6835956fae541e671fc	2393.4	16990870.385081722701146078	3913289	44	0xd22579b0f376b528cb3d9537cb8f70976d56d4c083d0d140d02431681067b930
933	0x0000000000000000000000000000000000000000	0x79e2d0ffa68d9da247c66d4c5dbfb4ef093f4fbc	718.02	16991588.405081722701146078	3913290	39	0x0f20880da86adb0622fe88392e5800eb5f01c27c3d9d9e0664a3788c8279f0bb
934	0x0000000000000000000000000000000000000000	0xfc2ff6c31c3a4cd32e193cd61ad376cc818f32e1	229.7664	16991818.171481722701146078	3913292	21	0x15f4ddb50c69f6a7298fb346118fc980b7a2149370ec1f63bb1699ca1d7f06d5
935	0x0000000000000000000000000000000000000000	0x245d3755f631025b335f1acecf1ac89b486174fb	743.4156110856	16992561.587092808301146078	3913292	25	0xf8b0d0f1a2dad312e2a07d31062d8d51f9de003350e686bc0768fe5637f2fdc4
936	0x0000000000000000000000000000000000000000	0x1f9417947f15a8744f41997bd03d782e01c3761f	718.02	16993279.607092808301146078	3913292	37	0x27a63b1431189aad9dbd75f343a670a4d085b8a21aa1756333b2fcf4a87785e1
937	0x0000000000000000000000000000000000000000	0x89a61a6d6eb95f56da5bb2f5e879a569d85967ef	6170.55999997782	16999450.167092786121146078	3913293	6	0xc5d280915d683ae3e13becf471952fb96b5665066f09015d6b8fd8e288590bdf
938	0x0000000000000000000000000000000000000000	0xee4a5d0677764f6cae9e4c4caf497b55fb264bb9	478.68	16999928.847092786121146078	3913293	11	0xaee4925e19c8878668bbadc6da543225080354edb2501482611c1ed404c3dc76
939	0x0000000000000000000000000000000000000000	0x4aaebf81394a29aab9f98481f91c27eff6034b97	1416.8928	17001345.739892786121146078	3913293	12	0xb6edd1d5431b3267331dfb6cd806cf7f5852b3d3e23921cfc9c614720f638868
940	0x0000000000000000000000000000000000000000	0xb8d0ed13b7238c954a75b48d2b0a6db359635dd9	2393.4	17003739.139892786121146078	3913295	14	0x7496e1ae3a590d5289b39f7aed3a64d5988e01373018f18e0f20708148677711
941	0x0000000000000000000000000000000000000000	0xc4dff0cab36f3a10e965e9028ecac073b25f2ab5	239.34	17003978.479892786121146078	3913295	41	0xc7812cc33e245e8a95929dc83e2fd550c9ef54270cbd2bb763af44976b995a0c
942	0x0000000000000000000000000000000000000000	0xf1c4521b7109921ae191df02d24930270084321b	287.208	17004265.687892786121146078	3913295	44	0x2b1ab6e914247b30032c71025a3cb8f593ab359468d8c02961d9da66d8533edf
943	0x0000000000000000000000000000000000000000	0xec5f23f8afb7ec07acaf312f68f177c1a377c962	88.07712	17004353.765012786121146078	3913295	46	0xf91d9e4a9e0fd3116e27e46a04bdb37a01f43a94891ffd99d81b475d46ac2b4c
944	0x0000000000000000000000000000000000000000	0x4cbf1609748665388e4a0a3085bf73c948232de0	2393.4	17006747.165012786121146078	3913295	48	0xe10728361e10db0c864163f91dc197febca4cc21088bf2dc5580ad4e0ef833e7
945	0x0000000000000000000000000000000000000000	0xd755d45cad4b2227cc8a1575081fc99007b583da	287.208	17007034.373012786121146078	3913295	50	0xdd22b0f63be6ff82ccc68741d56c6ef4d51d3726ad6214e042dfa9ac4853b689
946	0x0000000000000000000000000000000000000000	0x72fc79d092fd93fc13bacc4bdf25ed83d13aca47	2872.08	17009906.453012786121146078	3913295	67	0x1c7e6fbe987b81f478752a7536fe0757029df21252c23397a30d13a5cd59679b
947	0x0000000000000000000000000000000000000000	0x6f09c2a07fe4e47dfb9d286e7db1a622249a3170	473.8932	17010380.346212786121146078	3913298	0	0x51fabd0c6a707730d81996f021a207ed08d6b360c58ce9b57c66372187fcf239
948	0x0000000000000000000000000000000000000000	0x23cccfe7076a07b995c091f9205f57c433e66d04	47.868	17010428.214212786121146078	3913298	14	0xc506f9f8849882a0e774ecbc2ed8f0835152b4b8f66c457bc329f42b1a2c2cdd
949	0x0000000000000000000000000000000000000000	0x99d2a40d8a76505de2344682e3a79cdd71775685	478.68	17010906.894212786121146078	3913298	27	0xccead9123307a28413348481e13ec81a0ef1f5c226c918df8222b9bde7d71128
950	0x0000000000000000000000000000000000000000	0x38deac44707c1a995b1a06124c98db872c4b0c74	191.472	17011098.366212786121146078	3913298	29	0xe88acd7607ea78306dc0d1e9c6da6ed3460dd680df42a7be728ae60b575b27ab
951	0x0000000000000000000000000000000000000000	0x5d1207c231795284bed373bb5da22e8a2e31e291	95.736	17011194.102212786121146078	3913298	30	0xea854c4380f494c3a95a2f72b446836b0b23b327401f2a7b64619e00afee09e2
952	0x0000000000000000000000000000000000000000	0x44061be116a5cf4c9faa9c21077a7924da9cb99a	19147.2	17030341.302212786121146078	3913298	32	0x9170f16517620787536fa9a4c348533d25b6166925a32772cfb92e512a152104
953	0x0000000000000000000000000000000000000000	0x4d8a156be7587b2085abf27a6b8f63155623bfec	263.274	17030604.576212786121146078	3913298	34	0xb95396b4f77bf7b8eb47b9b5c6d3dcfcc308c9eb742b48608ad583ed32365b57
954	0x0000000000000000000000000000000000000000	0x8d01ab2c7f377f8f0c6544f3f907ccf86f9951c9	157.9644	17030762.540612786121146078	3913298	53	0x54288d342ab7aaa27180a0dcf1a28c3e471bcf4ca728901b66aaec48bbbb360e
955	0x0000000000000000000000000000000000000000	0x5bfd721c27c90834b0f761cf224703380f413596	3350.76	17034113.300612786121146078	3913298	75	0x10be4f371ca2e403c34589ee98f1ef8273b5b81f127715c34a2035e3ab43a923
956	0x0000000000000000000000000000000000000000	0xabf26352aadaaa1cabffb3a55e378bac6bf15791	478.68	17034591.980612786121146078	3913298	76	0x23fdb77006b57a0c3b670f2c3c067efdfaafb4c2512d7afba6336bf37c0adc5c
957	0x0000000000000000000000000000000000000000	0x1c3cf7fac231af1008d216f2e7556fd003a9917e	239.34	17034831.320612786121146078	3913299	13	0x560fe1cd4751587826907613e0baaa628af494c254b0c5badef5ebf9c99e82c4
958	0x0000000000000000000000000000000000000000	0xdf7117bf73131db0e1bde2f43a13796ee2f15582	287.208	17035118.528612786121146078	3913299	14	0xee2009a28a8ab705e84cd5cce00536d7d9e0c9042799a83a48eaf70305558b0a
959	0x0000000000000000000000000000000000000000	0x0478c8faa8f9863bfb69b389866d5e2fdad62032	3829.44	17038947.968612786121146078	3913299	24	0x9b7da34bceecd41180fbd057c1c008d85395bf0e04e7f42c5d3133de90ffe9e7
960	0x0000000000000000000000000000000000000000	0x15ee91fe19f7586f71da18982ab47cc78fdb1ebd	1436.04	17040384.008612786121146078	3913299	31	0x23fe18434d9a99095c400cbf0e5a1ef992246d02a3ca606020024d2f9245543e
961	0x0000000000000000000000000000000000000000	0xf16c3f22bbbf9f4289a09927c80df8ba152b3eee	143.604	17040527.612612786121146078	3913299	38	0x743af264097d03642a332e7adb21194253d4c45e0ee87ebe327cba8152538385
962	0x0000000000000000000000000000000000000000	0xd83fda2febcaacf9da132482931d343bbca0c7cb	4786.8	17045314.412612786121146078	3913300	9	0xd470c76e49a55c930646c9a0b5aa42f38e97270f75d0ec0541506c59c8bb3acc
963	0x0000000000000000000000000000000000000000	0x9bccba390ee29fb62b8f21e5e3f8b3f84d587e19	957.36	17046271.772612786121146078	3913300	15	0x8a9449a8c528643583b16d09abd653cfa64a9119d28c825cd9ddefaeb24ea32d
964	0x0000000000000000000000000000000000000000	0x82ef02b654b0e74990362eb6ac151d1c83c85b85	40.6878	17046312.460412786121146078	3913300	47	0x51b8236b41b793389d2f22927d7524d2cd840748e14438eaa7f315a7067c31f3
965	0x0000000000000000000000000000000000000000	0xca27f388fe39d2880722a4d5650ba5d45a6fff8b	143.604	17046456.064412786121146078	3913300	49	0xa65d479c28d2459a9539cb576d9d53ce9d145d113e5602fd3d6365bd8b34ec38
966	0x0000000000000000000000000000000000000000	0x615b9351251b05a8ec82b97c667fe31ea4a1ed16	971.7204	17047427.784812786121146078	3913300	77	0x733f358c83e2ce01defe4a93818235b1418fcd1604eaf6d8961e7684166ab0a0
967	0x0000000000000000000000000000000000000000	0x06bdac1897c469b1a2878a6deabd07978eb1ea2f	95.736	17047523.520812786121146078	3913301	13	0xa6dc80fd3569c347023f06d8502f59c4c75410e64f79241c9258ec0bbb0f429c
968	0x0000000000000000000000000000000000000000	0xfebae6f3c3010e87d6d6cd19b01c319fb2a780bf	31114.2	17078637.720812786121146078	3913301	38	0x758090539dac6393dab4c8d69f273963faa69b7324dc2287dd803a1a134d0735
969	0x0000000000000000000000000000000000000000	0x8d4d53db8427ae5a5f86380c54d508695b29a6c2	957.36	17079595.080812786121146078	3913301	39	0xba00766a581141c2adb262176e237dea4d3220348401354d38a30503ea828f29
970	0x0000000000000000000000000000000000000000	0x2f05617291ab3bdb23c5dbd62ab68b66ab04ebe7	430.812	17080025.892812786121146078	3913301	41	0xe918c5ec42779c5f7de7bf0470417b18e34f0d7550a34a9cc0b78a53a1da0250
971	0x0000000000000000000000000000000000000000	0x62db875fd1205c07ef42efaa78685c0e37f4245e	957.36	17080983.252812786121146078	3913301	55	0xc813755055daa56ef3491d8b2af9a7ee2e6fe71b0ffd987530cb4319cfedd29e
972	0x0000000000000000000000000000000000000000	0xc83996079a49ef6311859b7c3629a19503cb8c4d	3829.44	17084812.692812786121146078	3913302	5	0xab1fd3c5572b349c818288e58c14203aa33e008e5be33af6188e86dbec0d3fab
973	0x0000000000000000000000000000000000000000	0x655d2e4e997040752edeb3f12808300e46d14e10	478.68	17085291.372812786121146078	3913302	6	0x22f5038aad38e79adf65252ce953ed78f682d50a502413871a47330a8a2cd55c
974	0x0000000000000000000000000000000000000000	0xaf308156c2a172747592111dd4c01fd1c739d9ab	478.68	17085770.052812786121146078	3913302	26	0x21484990732fff80762be7407ac7ca91e04f99c058c9e830a888e00a8847ad78
975	0x0000000000000000000000000000000000000000	0x2624c5b3ff77dd612b67b222aa3bb4a44bc719b2	4786.8	17090556.852812786121146078	3913302	39	0x646b077a2a1bd9378f72647dc0a4c1304551854b0dcca03bc63afc9b388fe642
976	0x0000000000000000000000000000000000000000	0x706f4de066dffd88a14910df462fe27ef0480378	478.68	17091035.532812786121146078	3913302	47	0x9b7f30dfbfc188ddd0d8f2af1a2cf0a77c360e20013ecc85b84401de2de841ba
977	0x0000000000000000000000000000000000000000	0xbcd7ad07a1f9f4d7bfae786ce0747a3aa20104ba	26758.212	17117793.744812786121146078	3913303	1	0x954e9aa22f3d759727d5e02f366d200a4bc38fb8e71bb6af10ee30521a775d20
978	0x0000000000000000000000000000000000000000	0xd5b9421b6eb54658b348990a75b8b229d2c20e0d	105.3096	17117899.054412786121146078	3913303	4	0x160ccf97deaa56b720f5441cdb87e1c2d93fa5a81c187c5b86be68644a4ccbb1
979	0x0000000000000000000000000000000000000000	0x6d898ff0dcd9372fb426c03f5a3f1e402bfb41e1	119.67	17118018.724412786121146078	3913303	5	0x364d520b3f1d32e9a241bf570574ef6b07c4e3072eb89b135e3244118debf08a
980	0x0000000000000000000000000000000000000000	0xb1999520641762786ad0d08e81ebeb77a482cbae	1723.248	17119741.972412786121146078	3913303	6	0x42fa006259a05b284a98dd8dd796e1e1684b7993bd0246f621c53dce55ea92cd
981	0x0000000000000000000000000000000000000000	0x451b3699475bed5d7905f8905aa3456f1ed788fc	3255.024	17122996.996412786121146078	3913303	12	0x99b87b133898bc9befcd9364e724dcc69e3d28e7300125bf93052a7ca79dfbc7
982	0x0000000000000000000000000000000000000000	0x8084bb585b4dbdfc4ca95d1d49c6badf1109e4f9	957.36	17123954.356412786121146078	3913304	2	0xab9de3ee1c7f1f189fb2d0573db054ce175bf57d36290238a2de700c8a4e63b2
983	0x0000000000000000000000000000000000000000	0x9f48209b447c3f14d7b2acdf793b6ee14bc7fb9f	9573.6	17133527.956412786121146078	3913304	20	0x55339a2ff1cdf6bc3e2c6dd39458a2412cfdeda8bc3a0f2f8c5d18a95fd4c4f7
984	0x0000000000000000000000000000000000000000	0x91da6d02641ca6c3e567f0219dae6bcdab52cc6c	143.604	17133671.560412786121146078	3913304	22	0x852db1c81754a416b023e54493c4781ff24fcf5474a4a6038e80c463038d1bc4
985	0x0000000000000000000000000000000000000000	0x9de802ba9a2c14809306d34556b4954ab31a9c1b	2394.5546072742	17136066.115020060321146078	3913305	1	0x17a6e11e11a6137f3b9dd40790f010fe35aaa439a6aac7853df8c8022f9a9d43
986	0x0000000000000000000000000000000000000000	0x48c1b08e180bb0513ce0513cfd4992f86d04a1b4	157.9644	17136224.079420060321146078	3913305	17	0x3897d90b5f08acd985e99b817eb0211c0559ef90634317030e181252c58dbbba
987	0x0000000000000000000000000000000000000000	0x00ab883573e2e908a2b7ecc009199db2efd73b2e	88.52037768	17136312.599797740321146078	3913305	24	0xae2a17e5879b6671dcba6cbcd054bca60b464eba01c845b1119dc53dd148a6d6
988	0x0000000000000000000000000000000000000000	0x2ecbb905fe50b0a372d9060187a3c4b98f2d5254	71.802	17136384.401797740321146078	3913306	25	0x97e5c19638b91dc8f3fc313d78d7a15bc503875ba9874eb1a5633d99d99470bb
989	0x0000000000000000000000000000000000000000	0x1fac0908c5945b6150051f12866c0bdda169f600	957.36	17137341.761797740321146078	3913310	41	0xfc8f06fd646b1dd66433a46e834ea64af998f0216dda78e24ad20d5f7cfc3f98
990	0x0000000000000000000000000000000000000000	0x3e4049ee14211e46dab77a2d53014f9d296db4a9	129.2436	17137471.005397740321146078	3913311	1	0xb1463110bc05b10a0c7c2b10526f467f80889ceda1fe3b726c9969d6131a32b0
991	0x0000000000000000000000000000000000000000	0xf7ff150d81894beb14dbe332f7460a6f25b5ccb5	933.426	17138404.431397740321146078	3913311	29	0x54d41f0b3d52c880bd40aa61a5f30e7dafb2e4bb3a9e28fd7fa44f182839d254
992	0x0000000000000000000000000000000000000000	0x35ad29968e25268c5469769613089bce113b8509	478.68	17138883.111397740321146078	3913311	35	0xce86181ea5f1884fa833208d9727bb2d015b5764f871c9aceab1b0b0e69f2a2c
993	0x0000000000000000000000000000000000000000	0x2ad39710c6b5f95a8a16e9a29cdfe57fb37c7062	574.416	17139457.527397740321146078	3913311	38	0x041a4b8e0d9824f4ae96ce3af94bc9463092d0d00f8e70af49b1cdbebd01a00e
994	0x0000000000000000000000000000000000000000	0x457485b5e312bdd809e94218915694dc6f092c95	478.68	17139936.207397740321146078	3913311	45	0x9539265b00545e113edc76c8b64b195979949a3ae5cbc9e21d5979217b34fbef
995	0x0000000000000000000000000000000000000000	0x537f9d4d31ef70839d84b0d9cdb72b9afedbdf35	11488.32	17151424.527397740321146078	3913311	46	0xda7600a9999a9d184c1defc6bbd0ddf7c8cc34dfb9319f78cb8dda2245faa849
996	0x0000000000000000000000000000000000000000	0x718fde143050ea3cfaee2d94e02e7ab7d711e043	95.736	17151520.263397740321146078	3913311	68	0x1a4da76456b6c38785aa2ec205581f9d9c077112c39934b49427687ee1d349bc
997	0x0000000000000000000000000000000000000000	0x70cfbb2b250ab7066916955fa3efd3d264239151	62.2284	17151582.491797740321146078	3913311	80	0x9d4bd77e3801f11b5cca1c1578551a4c9a07c57108af0b25e61a69e50752a30e
998	0x0000000000000000000000000000000000000000	0x3a594480c467c4aa421c027bf293501afc9a436d	478.68	17152061.171797740321146078	3913312	1	0x3022fa17bec2fd9e185fc95ea90e8f1ea5ab5b8a5c9646c3e5460ed45137bf31
999	0x0000000000000000000000000000000000000000	0x753e1cbb68700c84992f59f793813a847c15d9ec	957.36	17153018.531797740321146078	3913312	15	0x24aecd7773eedec016e93cbd5e12eba798a5a3aebe6a07b152079c06fb57c0a2
1000	0x0000000000000000000000000000000000000000	0x826f6b1f0ed182c5d96891454ddf538988d638f2	76.5888	17153095.120597740321146078	3913312	21	0xa44b3f787c1e87bb04d90b13b874219f9abeadc59b7feae3315d245a593009cc
1001	0x0000000000000000000000000000000000000000	0x5eca13dc5a1653666d009601f0675d0aa53a2d0b	478.68	17153573.800597740321146078	3913312	38	0x3c5bcb27c3f22a376c6f5015ebfdcdc625431ee10ef32955cea9966355872eb1
1002	0x0000000000000000000000000000000000000000	0xe72461476250ba0067f36f13a0d9371b31bc1ad0	45.95328	17153619.753877740321146078	3913314	50	0x29cab91bfbbc59f25be48488d4ae45e397bc6f91ab72ec226a0855ab4cedf52d
1003	0x0000000000000000000000000000000000000000	0x75fabfe2063c9d577838442c97e24369d2c42977	55.52688	17153675.280757740321146078	3913316	18	0xc0032c1b2a00b1288ea16db39a5d993d7f0d7a2138fb61a6af160be302a1e5da
1004	0x0000000000000000000000000000000000000000	0x41347bc979b07ae719534574214cfc3ef4af553a	670.152	17154345.432757740321146078	3913316	19	0x5b613836531680bb8ae81a691a5ad5ba792b6c6ac9f3470514243ee1d9b542f6
1005	0x0000000000000000000000000000000000000000	0x4c6b65f9de8c074cf93f384f2640c475fdc3f9bf	143.604	17154489.036757740321146078	3913316	41	0xc0bc39c49665d495f85f1e2addccb40edadccf5f1a6b9ebc9b23b2515b89cedb
1006	0x0000000000000000000000000000000000000000	0x3e8d412c0abff2edca2a987149aa6aec7288912a	239.34	17154728.376757740321146078	3913319	0	0x0d2c9c2d7ef116487fac03e7388e393fcb9c0d5f17359380e9cd6588358c6359
1007	0x0000000000000000000000000000000000000000	0x8f4194c5bfd1feff7fc771c2f7b734ecebdb7e63	239.34	17154967.716757740321146078	3913319	9	0x24448f96fb466abece0a4e93873ecd02cd22291fe7e6b9ad8af206abae211ebd
1008	0x0000000000000000000000000000000000000000	0x1552f4d3e5b5d0cffc14009ad28fec9c2e0d768a	957.36	17155925.076757740321146078	3913319	10	0x28717f50cbdf166aa6c1584e3947f44cc0bb90bdcd3b9c49b5994c2ed8ff6999
1009	0x0000000000000000000000000000000000000000	0x4cbf1609748665388e4a0a3085bf73c948232de0	7180.2	17163105.276757740321146078	3913319	12	0x933a48f22b2d1260ccd10cd93b13a9a2842fca9708d8d165bd41e149cd680ad5
1010	0x0000000000000000000000000000000000000000	0x67757973ba4a6c1f620a510ef534d77c461b87ee	86.1624	17163191.439157740321146078	3913319	13	0xe2a68b4c4aedbd84fc9c177aee83d9529a9529217380117c26c50148ada4c5fc
1011	0x0000000000000000000000000000000000000000	0x88795093abca86155f44cb90c4dd22a017b3a61c	47.868	17163239.307157740321146078	3913319	19	0x4f2ed2c96028ebf3223c20ace3d0ded39d3c4b2d02094b38b1d672e723ed38d0
1012	0x0000000000000000000000000000000000000000	0x44d9919d27f16580be4f57b94d7ed5c318ec75af	1316.37	17164555.677157740321146078	3913319	21	0x7460df06295aaf7311ecbafce91ce8c5b68e01271d5fdb8b51106195f3d5c421
1013	0x0000000000000000000000000000000000000000	0x977d257d30e6e4973e256ff0776a9134b620abcf	2393.4	17166949.077157740321146078	3913319	26	0xf36efd4cd0874fc80190bd8a4981e7e42d5faa28e621e36b8cb7d0dc2221ab97
1014	0x0000000000000000000000000000000000000000	0xdfa12c259557e3626216cce14d3f8fb6ade206d7	239.34	17167188.417157740321146078	3913319	28	0x5d176ee467c7138d6dd697f91bfe221b9f8375f8fb3e8daad3d38f1d06122964
1015	0x0000000000000000000000000000000000000000	0xaff07b32da7e1a91fa0bde6a91ccaed5e559c61d	478.68	17167667.097157740321146078	3913319	30	0x79c3da39809c929df165d6ccb2c0a899b0cb9c49e4cf202b3053bb868345a084
1016	0x0000000000000000000000000000000000000000	0x6b54d293c50daafe0b5906c8e9709d15c731bc62	239.34	17167906.437157740321146078	3913319	42	0x4f21c0fe381f3db9f2845f5ae5a87b9d5c2cff68fc71aa3573a890d7fc813c37
1017	0x0000000000000000000000000000000000000000	0x06bdac1897c469b1a2878a6deabd07978eb1ea2f	28.7208	17167935.157957740321146078	3913319	51	0x5debebeed649c24db348b219e90e5b1b05b14668e10299bd412c5b20754ec2c9
1018	0x0000000000000000000000000000000000000000	0x655d2e4e997040752edeb3f12808300e46d14e10	1771.116	17169706.273957740321146078	3913319	54	0x831e37d83c29a46e347b8e4b4dd9e361aba6212077d6ab243f2c39f52c9b6c1c
1019	0x0000000000000000000000000000000000000000	0xd895b5a39a39c94e089fda2ad4e518222c0a3a6d	256.57248	17169962.846437740321146078	3913319	56	0x990bb7d9e586eaaa306647362884266f6c2f6d4ae3dff7c5762455e0d7f47e2d
1020	0x0000000000000000000000000000000000000000	0xecdb204e497ecafaee88b36d654dd3e9e976f719	478.68	17170441.526437740321146078	3913319	57	0xad6d1ebb0f777b31b6d38f03a50bb48a572106984f354c2e3577deff544e2835
1021	0x0000000000000000000000000000000000000000	0x706f4de066dffd88a14910df462fe27ef0480378	7180.2	17177621.726437740321146078	3913319	68	0xfdaf9938f150089d090f9df14dcaa27614fbced924533bbbc10fa899902e2174
1022	0x0000000000000000000000000000000000000000	0x6f09c2a07fe4e47dfb9d286e7db1a622249a3170	952.5732	17178574.299637740321146078	3913320	2	0x2ac22e128ebfaf9433e03430364ad944d53fd60619648f57a2aea0e1ea8f2781
1023	0x0000000000000000000000000000000000000000	0xedd782ab2453a76d0a58618ea26a7a44961c40fa	478.68	17179052.979637740321146078	3913320	5	0x784ba36bf87ddfc5c5a1583bc62186671657c7bec11f3797721e84491c3b3148
1024	0x0000000000000000000000000000000000000000	0x6be93e20b32bb4803bbdec5010b4f12335d48075	7180.2	17186233.179637740321146078	3913320	8	0x02a940e034ebff7e3eacf14bf1170d4e2f626baa171d21e67b9a0ef6c5aa204f
1025	0x0000000000000000000000000000000000000000	0x0792e98b997b63a8fe917e84f6bbd57eec95dfcf	469.1064	17186702.286037740321146078	3913320	19	0x1fc89612f6d1fb4a7b7c6d160d379338f9e23ed6c6f89e1afd4b73a89e562351
1026	0x0000000000000000000000000000000000000000	0x7ff875d32ebbc4227d7cc25553c10017ea0dc917	119.67	17186821.956037740321146078	3913320	20	0x2018b4a37a2e444b0cb9b5d59c8f12f624e7dbb0297b5a813e88b0578eeb8f58
1027	0x0000000000000000000000000000000000000000	0x9d3171371a2aab918210496646d686ac74ece32a	239.34	17187061.296037740321146078	3913321	0	0x07b69269ba4afe34eb101e526881a5cb13a7def327086a512d38083a43022f5b
1028	0x0000000000000000000000000000000000000000	0x558df69374b708c96de4be3fd26b4e598f7c0dd2	957.36	17188018.656037740321146078	3913321	2	0x266cc538e18493961127fd03d74d2df7d236b0bcb6aba6487e98827763591f59
1029	0x0000000000000000000000000000000000000000	0xdaf059bdd160b192853d916d5bb3aa6f20713b98	114.8832	17188133.539237740321146078	3913321	30	0x8df1793fc24907fc92981ea00be1af32dd99a09c7ba2319d253975fb27d0d56d
1030	0x0000000000000000000000000000000000000000	0x8727de2b01561f76be827cc6a3ec0cdc276f4b02	478.68	17188612.219237740321146078	3913322	8	0x7917e35b9333313a3e90cd199be9889d6340bc82798ef88d5a487d341252df4d
1031	0x0000000000000000000000000000000000000000	0x31fd36d29201d5d5f276989626af2b15b11ba520	335.076	17188947.295237740321146078	3913322	43	0x7c4bded93a37ea44aec2ef29e6fcc6bc73a3ac9d55b727626be95815879206e8
1032	0x0000000000000000000000000000000000000000	0xf16c3f22bbbf9f4289a09927c80df8ba152b3eee	143.604	17189090.899237740321146078	3913322	62	0x713e066be45ef1662fce8b04a85e975852ab81e15c4599e78f65db9e4cfc1373
1033	0x0000000000000000000000000000000000000000	0x8d4a932a911db41518fb69c48b559ae4dd2a25d0	481.291109766595584	17189572.190347506916730078	3913324	10	0x40b08095d9a8c9c660b5eb4ca4e963fe8318925cafd434e0b679f8ebe7c2f7d9
1034	0x0000000000000000000000000000000000000000	0x6e9f3b618f240240d359435747bb37729442b152	23934	17213506.190347506916730078	3913325	2	0x258be534f4011978b16e84b6689e472192b67825e6cc2c336301f7d1f688a429
1035	0x0000000000000000000000000000000000000000	0x40c2f3eb1bbf212d1584e7059b25424ea693a17d	478.68	17213984.870347506916730078	3913325	8	0xa322a2f863a805b93e1154946a4635569b8dfe65a2288ae82818ee868824db2c
1036	0x0000000000000000000000000000000000000000	0xdaf059bdd160b192853d916d5bb3aa6f20713b98	2278.5168	17216263.387147506916730078	3913325	9	0xd06a25718ccd937303e543bdb6a5d1ee8eae313c760de09ab4c81092a0366ad9
1037	0x0000000000000000000000000000000000000000	0xd271ec604ac098111601533e36eb79700853da18	1914.72	17218178.107147506916730078	3913325	11	0x49f0803140bd0d2aeb127fd38b3f5a2371b61a0026b6eaaa7a0c7ef4dc1d3fb1
1038	0x0000000000000000000000000000000000000000	0xa7f56e11f3ecb7b11bfc195fe7069e46446e0f7a	957.36	17219135.467147506916730078	3913325	13	0xba37a6fb0541601bdf48c629b2e6a97108305c85abca23d52e13ffa97dbdecea
1039	0x0000000000000000000000000000000000000000	0x34e5fd9fb557b6bfe5ef3475fd25139951ff515d	981.294	17220116.761147506916730078	3913325	18	0x561f0ab745b138ab5a329ae7a6b6f7c29f4140f23ed61c492aa394341b02b7eb
1040	0x0000000000000000000000000000000000000000	0xac2586c4a198356fa3b5eec2bf8f2e63166aadca	19.1472	17220135.908347506916730078	3913325	27	0x0d8cb9484728cc38d3d71e6e957708353cf5471163f1dc1e16cf53c598646569
1041	0x0000000000000000000000000000000000000000	0x70bf386a27c48a7a432f3c54bc3dc9db0003614d	478.68	17220614.588347506916730078	3913326	21	0x9e42b047492f09bddf316ed760d019146aee59117e64bbdde2892031f8f23cb3
1042	0x0000000000000000000000000000000000000000	0xcf74846794407c3dee1d92a930ec598382c85136	1436.04	17222050.628347506916730078	3913327	46	0xbea5e12745787afcba6771456c6619728c266eeb788586d78e6a37c96e5ec8e6
1043	0x0000000000000000000000000000000000000000	0xf65a3e487d8a7f4ff60cc23aac55b80e4318192b	4786.8	17226837.428347506916730078	3913327	47	0x10633183ca8632eb86c9e42d8b35f65302a13d495fb19d0e7ba575a67c196772
1044	0x0000000000000000000000000000000000000000	0xba28c1b409664c0893a090d637a027e4162a41bc	4786.8	17231624.228347506916730078	3913327	48	0x366f39efa35cb144cd1414715a79ba09d999eeaf36aa0950f2b6f81a2bd52da1
1045	0x0000000000000000000000000000000000000000	0xfc1bb70db33436eca210bc6562d91aac15f8ea36	430.812	17232055.040347506916730078	3913328	3	0x120b80637ec118ce8038d0e47b367fa193a73e2627ff707979c81f8793e1566f
1046	0x0000000000000000000000000000000000000000	0x3be967ab77c20c593ff089902bb49695f0c4c43c	239.34	17232294.380347506916730078	3913328	5	0xc395bbe5d1cb482e6f543f625b767e8c3846bc946868b154bfbf5dfaf6a329e3
1047	0x0000000000000000000000000000000000000000	0x073e870429b407cca4d789900b4f8fc3e43ded2c	9573.6	17241867.980347506916730078	3913328	6	0xcddb53c4808356febc8396e087538a6b0d16cfdb8ee588d15b31e041f00eb168
1048	0x0000000000000000000000000000000000000000	0x52284b841362691e77545fa9c65feae2d8b7355d	4308.12	17246176.100347506916730078	3913328	19	0x7766a1e1dfc33ea8a1d0a1c2a4a1f4e86fe6c91b0c6d7252076e0e6339609c3e
1049	0x0000000000000000000000000000000000000000	0xb2adaf8820f076ce8f160544988461288732abdd	91.90656	17246268.006907506916730078	3913328	21	0x9ae58f2efae71c02ef8f2e192184b80ba27d33d2644db696582febb17700ad1d
1050	0x0000000000000000000000000000000000000000	0x0cdc16b5fbb08e784b1eff24863d454e8c237a2c	957.36	17247225.366907506916730078	3913328	30	0xba2d5abe5e55602b789cf12b6abef73203348496aaf585819dacb1540f84027d
1051	0x0000000000000000000000000000000000000000	0x0ad30cce08e30bc44680bf76862c04ddd7ea1f5c	52.6548	17247278.021707506916730078	3913328	45	0x1593457056b8d1b3c22db97a6fafede6d05372fa9b18e9c16f70e64f50d068ab
1052	0x0000000000000000000000000000000000000000	0xd035047b8668774594119130293ba87611a82220	574.416	17247852.437707506916730078	3913328	61	0x4884eb0f5d157ffee35036d817497d0d05f0925d87b883bd00231587d7e70db8
1053	0x0000000000000000000000000000000000000000	0x98b6371f584b45a302d9f09e8741c4f0e4526bfa	1914.72	17249767.157707506916730078	3913330	0	0x7f93d4877a382f6b5c060962f4c9e7286c1789473987def3f7544bc4d3f711d9
1054	0x0000000000000000000000000000000000000000	0x52f91575936bcae2e33208992f3fedc775535c60	957.36	17250724.517707506916730078	3913331	22	0x8de6b9f708891062039f97886ccf0ebf4d617ddc2a05e50b4fcdec1667985a60
1055	0x0000000000000000000000000000000000000000	0x001d47ad514370f6e1f6126a4c59772ec0706f4e	239.34	17250963.857707506916730078	3913331	23	0x4046b1411944218c84aed5491b5cb10d9e4edb2916a3cb7949933bf38c0e8236
1056	0x0000000000000000000000000000000000000000	0xe6186b15098f801403f16a8366e801f0fa1cf2e8	1914.72	17252878.577707506916730078	3913331	24	0xf778ac397a57ea667d30d5e0aaf66cd44acf1d85d279248ef9ab2ce05a5592be
1057	0x0000000000000000000000000000000000000000	0x738a61fb51ee11d208653a45096479c36a5a564c	478.68	17253357.257707506916730078	3913331	25	0x0dda093ac419c7f68d1a5f2f75342f36ff1b63b2e0e613bc168e467462a181eb
1058	0x0000000000000000000000000000000000000000	0xc9473e3e93023162095e3b4ae31808eebc83581b	3781.572	17257138.829707506916730078	3913332	0	0x38016288cf5d4fdde781f422a7e610a9f64f7e4d086f840eab91ac0c041f1253
1059	0x0000000000000000000000000000000000000000	0x4140d3f33186fc111db5f21abd5dd758290f010c	239.34	17257378.169707506916730078	3913332	2	0x77a07528ee84ff2ec20aa114d1e8fff43382b180ceec3cd7709060d459a98f63
1060	0x0000000000000000000000000000000000000000	0x584d71aac1342a29e5ceac6cf39b334c35936d4a	47.868	17257426.037707506916730078	3913333	21	0x12ac8aeff7c096b1a5fac94e655e6e47ee616666c53abf2ceef45c8745be5dc5
1061	0x0000000000000000000000000000000000000000	0xb7f1498898d70685851b5331f64bf26215f00415	234553.2	17491979.237707506916730078	3913333	27	0xf81c5a9229a60fabe39ee5e71e15c03f4dcdb0fa8628a8d65419c07f29d7bb21
1062	0x0000000000000000000000000000000000000000	0x90b86e1f837fd7eb736e0b4a928ba0054b7b5f92	957.36	17492936.597707506916730078	3913333	60	0x70160bee9b9bc5be730fc386c19eee76c47f1bf673c797e3686809f263919916
1063	0x0000000000000000000000000000000000000000	0xaff07b32da7e1a91fa0bde6a91ccaed5e559c61d	1436.04	17494372.637707506916730078	3913333	62	0x163797befb5049e480255135b12eb68382f077be145aceb12eaa1a0529908a49
1064	0x0000000000000000000000000000000000000000	0x7ecf87e8713722e6802f018c2cfdc714599b814e	2393.4	17496766.037707506916730078	3913333	66	0xcb81ffdf2e480c54064d35fa2fe3a743c64d13e2b42300d10c7b82087b284263
1065	0x0000000000000000000000000000000000000000	0x231526f8d251f610f7f74e5f6f80f0ca891933e8	191.472	17496957.509707506916730078	3913333	82	0x492ea41000cbbf44f9d2d71bcc9b9fee6c08b32d0ce387d564c646aabf232589
1066	0x0000000000000000000000000000000000000000	0x9a74a33639fadff95bb54fbcf05a151a112e6032	957.36	17497914.869707506916730078	3913335	13	0x4e1fae011afec75f4718264ff9e3287b4f4cb03f13855fe61fe1f1216aeb56d9
1067	0x0000000000000000000000000000000000000000	0xfff78f0db7995c7f2299d127d332aef95bc3e7b7	19.2585912294	17497934.128298736316730078	3913335	29	0xf478dbb31c3a01ca556284e2d0ba9fd5c12a63d1a327dc558875165737a241a3
1068	0x0000000000000000000000000000000000000000	0x4d40fa121fe3fc0037c5d63c38986721204564ae	1282.8624	17499216.990698736316730078	3913335	45	0x4bb1963964a1656f9d0e0dd0276b14ce733504d8a8da419b9160fe495d1ddbfd
1069	0x0000000000000000000000000000000000000000	0x893f62b86ca094555884a1f5d3e032592bead7bf	765.888	17499982.878698736316730078	3913335	64	0xdfc8b44b56a4f29e60a82a5643db30193e57b5f451cbbbeae882dacc5706b7b4
1070	0x0000000000000000000000000000000000000000	0xf67fc8284747d0dcc11525b987cf1c7075b3d145	2632.74	17502615.618698736316730078	3913335	73	0x0b75ca6466b88d4c6d713522f20b9cc948489936ad0fd52f4188310cd8b9ddca
1071	0x0000000000000000000000000000000000000000	0x5702689cbd5970692ccfa5d1779628b072a95bd0	268.0608	17502883.679498736316730078	3913335	74	0x0f11dce86c92ea4a793f0e3eb3748e80b2990b92ce25ed8ef5e6378acbe4dcea
1072	0x0000000000000000000000000000000000000000	0xe62f6ae10cce0bd6e153e6b99eb329f7066b20ee	4.7868	17502888.466298736316730078	3913336	7	0x49789ccb66daef18060ce08f544f91d612f61dc02b99a61cf5bad45fd407b263
1073	0x0000000000000000000000000000000000000000	0x6ae43fe880ae668205814d4e9d3efe5bcc92b03d	11.967	17502900.433298736316730078	3913336	9	0x53321c66479db46ce5b16980354bfabb98dba13fed7384fdae971c85b2bd4bc1
1074	0x0000000000000000000000000000000000000000	0x4ad62af708c9583f15ca2972caa548bbbda835fe	1436.04	17504336.473298736316730078	3913336	11	0x5d537410b0f658ef11b03c4b6c8a6f61fc8cef26781c2000248132ff6cdb53a3
1075	0x0000000000000000000000000000000000000000	0xfb5f5e0813fd5e42cad44d6ed76f840a633a240a	473.8932	17504810.366498736316730078	3913336	21	0x9d64c7e43f090d832af3d43a50cdf004f3851b7fc33f0a133eab1dbb121d356a
1076	0x0000000000000000000000000000000000000000	0x786d4fa54c83383a54d863fc7e334315f2a58714	1436.04	17506246.406498736316730078	3913336	22	0x9dc5f69f92747e0bf26b0ebe8a75dc94c9c9f9f71003983f4a4c40a6fb4c4adf
1077	0x0000000000000000000000000000000000000000	0x746a368aaa0647a2b90b3c425a77de794e9c1d05	2401.9867310663139336	17508648.393229802630663678	3913336	25	0xf0b0d62c0d25024d383b54e65f0b9c90e6b33c260045d75211405ace4aabcd3c
1078	0x0000000000000000000000000000000000000000	0x465284adb50a669108bad57c1d9b7cb1fcfdd595	957.36	17509605.753229802630663678	3913336	27	0xf4a444f41fcbbdfb55d713cb408eee840f210e1cc24a78cf6e6b3df06049a4d3
1079	0x0000000000000000000000000000000000000000	0xfe0ec199309c5a9f23be42478bd115b17dbf71db	43.0812	17509648.834429802630663678	3913338	24	0x3080e8f7c280850260a21b1c2db41abfa2e250da61b7e27ab7809704a23495f9
1080	0x0000000000000000000000000000000000000000	0xf0fe105fb251d62d9da6e79d4bd33676abb41af1	4786.8	17514435.634429802630663678	3913341	31	0xd5047faac9b688d79aa5bcf630b82ce09edd8d8257e2b775d71420a64354db63
1081	0x0000000000000000000000000000000000000000	0x0bb50e918cca548b751f02541886e1a07c00d7e5	574.416	17515010.050429802630663678	3913341	57	0x323f11d55db71dd9bcba5f970993a5d44bfe14cc3d730d846ea446ff5a30a2f4
1082	0x0000000000000000000000000000000000000000	0x10d771d062ca432e0899cfcc88b834b612eee074	1436.04	17516446.090429802630663678	3913342	11	0xf11fe08768f49198727072c616fc7cb7ba98d9f6d57b2dae709cc076287cd895
1083	0x0000000000000000000000000000000000000000	0x00f20bb83fd516c8d2e365d4b21d07d721c24fad	478.68	17516924.770429802630663678	3913342	24	0x37d891bb3492c885c533acafea4a3bc440f187e9eafce5f9b6f419b5616d874c
1084	0x0000000000000000000000000000000000000000	0x7a244594bf307a96e8f103ec00501c2cd430989a	335.076	17517259.846429802630663678	3913342	27	0xa1560a6eaab69b25f2b4ab32208afeeac6c430cfe5264430a31c991b169a6d14
1085	0x0000000000000000000000000000000000000000	0xb819fe58fc2bb835d4e00090d796f33d68b04ee3	718.02	17517977.866429802630663678	3913342	33	0x7400bb642164cdf6bc3353acb669d0374dc430df95f941e4214b9d51fb86a4b3
1086	0x0000000000000000000000000000000000000000	0xfb0d8ca54de9fb8fd981d527e1c893433e65344d	478.68	17518456.546429802630663678	3913342	54	0xe73992f0a70d0a36d48ca9da389a1df6cf5bf8da1057e764e2b7f6687657d998
1087	0x0000000000000000000000000000000000000000	0xcb57b71b80a8bc545562c556d0e8c3de35ec165a	319.043283552	17518775.589713354630663678	3913342	72	0x881ec318bd7e4e380b9821ce96aa8db6220cc4cd47042daacd46225712119056
1088	0x0000000000000000000000000000000000000000	0x40c2f3eb1bbf212d1584e7059b25424ea693a17d	478.68	17519254.269713354630663678	3913342	87	0x045e4111a0adffd8610f1863e5e2a6ce7e4c8a67cd0a1eeb6d7686bcdf111ef3
1089	0x0000000000000000000000000000000000000000	0xef5feaeb48d2512a34e6eba9f7e637f1b49f8254	957.36	17520211.629713354630663678	3913342	102	0x0940fac23cd073a6a295e2dc6fc2bae22594a4bd15faa55698b994610215c159
1090	0x0000000000000000000000000000000000000000	0xe904f20b2b07e59118b6ca7936c23df5e2e847f4	2872.08	17523083.709713354630663678	3913342	124	0x6da979117958ace47f7c10901eff6e3c6f4705e0346078c7c75cca8805e1b305
1091	0x0000000000000000000000000000000000000000	0x448fa7a9f6eb9ed764ba1fd4c776a4373c9d3a03	2387.65584	17525471.365553354630663678	3913343	14	0x302a2cfb169e2553984e4e63ce59f730253d1e6a3d6cd28f26bfbe25a89f1d8b
1092	0x0000000000000000000000000000000000000000	0x35ad29968e25268c5469769613089bce113b8509	478.68	17525950.045553354630663678	3913344	57	0x0f059ff6f0a7ef8ede49a05946900b97c37f745451c9881216e486139029b949
1093	0x0000000000000000000000000000000000000000	0x6edc69b3794a1f0ca1c6b26a1b07b2e88e1f7495	27284.76	17553234.805553354630663678	3913345	110	0xdc3a6d28dfbac15c3893c3181e5ba101c11aa7f3795b5ecd7f0839dc8c931b6c
1094	0x0000000000000000000000000000000000000000	0xd90ea6bb71a83952160536b6d3d35035cfd709a2	2393.4	17555628.205553354630663678	3913346	9	0x9689a17208dfee042172c115cfc48446dd48384083b2ff5a40a385bbd8d90e44
1095	0x0000000000000000000000000000000000000000	0x95f7d059329f70b53570e5879aee1acd4dd49cb5	145.9974	17555774.202953354630663678	3913346	30	0x68dc03e4317cf29668b4c830abbcc270c8cf6cb4d61f3f20b71b830a29b11a8c
1096	0x0000000000000000000000000000000000000000	0x9915277e2237a571f211305d4b96a95a5cc2e26a	381.26862	17556155.471573354630663678	3913347	8	0xe6e7fca26c4ce3194dba1e2d16dcc5d7f6bcfc1086418b42b59611252f3d9406
1097	0x0000000000000000000000000000000000000000	0x26599f3acdf67c0065de28e6890de2c37d209bfc	775.4616	17556930.933173354630663678	3913347	9	0x06efe7fa04651a2b12f4ffb9f25598280d1296d5756fa19da759223161342545
1098	0x0000000000000000000000000000000000000000	0x7f4823876318fad7321fd813b7abd4a7c60c12a5	605.09552600976	17557536.028699364390663678	3913349	6	0x2822e3871cf56dfded374ed0d9bdf216326b2ca76505f3bb0a44096efd28a0a4
1099	0x0000000000000000000000000000000000000000	0xacd0fa618b9681248cdc4eec93f3c06ee32548dd	57.4416	17557593.470299364390663678	3913349	75	0x4bdfc478bb362db6f6f94c60ab944bfdcdb5f45b397c165ff492f51b8ac19aab
1100	0x0000000000000000000000000000000000000000	0x130095864efaad9f4a2dcb67903501edafaa8b1c	239.34	17557832.810299364390663678	3913349	77	0x4d6985b8fcc23328161b175d53a5916947c88e474661d71d5439e4cf158715c6
1101	0x0000000000000000000000000000000000000000	0x75b09622cb94b919e8887286d9c89c84988f1f93	47.868	17557880.678299364390663678	3913349	85	0x5d89c04c214434514751a0c026b7279abbbdc03607a18fa3743870dce35ac6d2
1102	0x0000000000000000000000000000000000000000	0xc62435340b544481bb309fd4f345b46c80c787e1	215.406	17558096.084299364390663678	3913349	92	0x6e47181faff64df37969806b967e0ffe4fc5585d57976ad9c09f442b819b0b43
1103	0x0000000000000000000000000000000000000000	0x65edda31783d594bd91d617241704a0f2bf39e00	957.36	17559053.444299364390663678	3913351	33	0xd04d7c77b3a0ecc3cc4488cb8289c17a3fa779b297f603b92e874b5038441501
1104	0x0000000000000000000000000000000000000000	0x39a186cbdb161b530174560137236b83dd7e1a98	1053.096	17560106.540299364390663678	3913351	41	0xe01cc93063ef9de604980ffeffa64c2d100c50e54c29e0f81000200fd2ade0b9
1105	0x0000000000000000000000000000000000000000	0xbb8b3842d4a4155b2f37f2b2f4d81f211fd1205c	47.868	17560154.408299364390663678	3913351	60	0x004492d2d82d4c6a7a35c31537a830257f1543596555ce5cbd2be427fdbd16ab
1106	0x0000000000000000000000000000000000000000	0x15d655abff6ae7f109ebf5c2259ea3ed7de97619	167.538	17560321.946299364390663678	3913351	99	0x2f33ad8241eb89498565b7664f519b3a6a46ee24de0c2f887ece8c35080084f5
1107	0x0000000000000000000000000000000000000000	0x880900c66a494893117110fe129e5705a16ab9a1	335.076	17560657.022299364390663678	3913352	18	0xaa11eaf9c4e200d8e20f255848213deff6a58a54f9bd014a6d27a4e97620068d
1108	0x0000000000000000000000000000000000000000	0x76436bdf4f3b3b9abfa08f825d2db471a4e33507	47.868	17560704.890299364390663678	3913352	53	0x55d82b43347a8921614812fed53b2c6a52e556d564058ac46b959b56f7b05f31
1109	0x0000000000000000000000000000000000000000	0x6132075b91fa4de329ef353813d44c741bd57765	473.8932	17561178.783499364390663678	3913352	59	0x5a3bafd057d620787708a5821ad62427d422b5b5451e237ae5e1d6407fd2e3bd
1110	0x0000000000000000000000000000000000000000	0xd21219629a610016ad7b9a6cb3817b372f422153	478.68	17561657.463499364390663678	3913353	0	0x080a36f46479d7ac25368f9061939b729e10579d140060f9eb8c432bbc5ac2b6
1111	0x0000000000000000000000000000000000000000	0xe16bb6525a51ecd86691839f6719fc3ae4d741c5	478.68	17562136.143499364390663678	3913353	48	0xd7e17ee92aa8a504bac9d7e97fae790ea40ef6e98ab7af61237e126aa454de05
1112	0x0000000000000000000000000000000000000000	0x6934f584bc6177bb171f2aa34ec4da5b53a3f0e1	35.901	17562172.044499364390663678	3913353	51	0xdeae440472846e6b2c46ad69ff633d628feb63d3a6f15a670d6b63f7ff579520
1113	0x0000000000000000000000000000000000000000	0xf16c3f22bbbf9f4289a09927c80df8ba152b3eee	191.472	17562363.516499364390663678	3913353	60	0xe8e0a1834d48f6963c9f1cb9b744883a4779970c5a7e5fc528a6a97f2a701fb6
1114	0x0000000000000000000000000000000000000000	0x00f20bb83fd516c8d2e365d4b21d07d721c24fad	9573.6	17571937.116499364390663678	3913356	27	0x905c0b1173fff2588e80d86244046b593c26abb0d61f5055cfd8d3e904aa61b0
1115	0x0000000000000000000000000000000000000000	0xd6f7c94c8e82c7e2e1234c636d509d9065b1c36f	478.68	17572415.796499364390663678	3913356	32	0x61d01bcaa3334a57ab4f541508cb44574f19ea865e02654f800d5b19610e323c
1116	0x0000000000000000000000000000000000000000	0x07ac5e60f9a1286f871289144a90ff56b7545fae	1436.04	17573851.836499364390663678	3913357	1	0x4c19ccf59069d338412e8b1d8f0cb384288f306ad4058fb8d86d5bc693ceb5af
1117	0x0000000000000000000000000000000000000000	0x96a5590984b674e1e1e6cb6a3719ef9b40a1dd5e	3853.374	17577705.210499364390663678	3913357	42	0x4d605d3f1ed94c2074cc787679665de1a3f3ceef7bcbebaad6f0ac9504dc5264
1118	0x0000000000000000000000000000000000000000	0x6ee9d727eac14bdf574bae6022a04c9c04373760	2151.6666	17579856.877099364390663678	3913358	36	0x56464233e0d1806f899102c5ebe3b89d25a90ae1b87ae2b5488716b03afe5666
1119	0x0000000000000000000000000000000000000000	0xe67df4c1b0eac6ea8c28467941a30a25ef82a87f	5744.16	17585601.037099364390663678	3913358	47	0xaece0e9644a50b6c71c760561ed967f655d684e45883f218670e7a4cf9e34710
1120	0x0000000000000000000000000000000000000000	0xe125421a275ea5cce63b264a4ead864b771979ac	1172.766	17586773.803099364390663678	3913358	52	0xe269444b9cfb8ba171e52f70388f81b2b0a79be15c33dabb3fa09da2c1088334
1121	0x0000000000000000000000000000000000000000	0x39a186cbdb161b530174560137236b83dd7e1a98	47.868	17586821.671099364390663678	3913358	55	0x9677e99f05178d89a32b99e6ba5296291b88d18ca1c1dddc4f083c43fdea6f3e
1122	0x0000000000000000000000000000000000000000	0xaf34a43c3b6e950f5e62660aaa637a220e36e460	191.472	17587013.143099364390663678	3913358	57	0x0bc6ad48081a597d530c74e7484c34a5b0c3f5a7975483f320a203bc8e327c5c
1123	0x0000000000000000000000000000000000000000	0xafa4c9a30920b6e85ffef3c115f197bb85b5977f	499.885524	17587513.028623364390663678	3913358	66	0x4d0f330216eb3d152f5c14bcc24624d9af345a8e963f9639235f26e925df5886
1124	0x0000000000000000000000000000000000000000	0x0075cae3313dc234f4961c7c6a8a8b390e4d4e23	47389.32	17634902.348623364390663678	3913359	30	0xa697d7bcea0634298a48a4b110d8093b77d6ebc60e5734fbef59584153e5fc85
1125	0x0000000000000000000000000000000000000000	0x0ea86277236097921d1c38e3de471800d1e4320c	382.944	17635285.292623364390663678	3913360	3	0x31591db64902df135844f4d63936447fb3d7a937bc7de89188679f5f54e1cdcf
1126	0x0000000000000000000000000000000000000000	0x2b616914ada8484ab9d70398dbe86b029b1a9a39	478.68	17635763.972623364390663678	3913360	18	0x11ac2a256781ed91d313d65fe1635ab960084a521e2f4c12a17a9b31c319ad22
1127	0x0000000000000000000000000000000000000000	0x5e0aa0f5b9adb5b147c895260dce10accdc70037	239.34	17636003.312623364390663678	3913361	21	0x3f40bef9c75ab2a5103b53f35836fa70480ac18d72bf1bb1fad1639a20afd49e
1128	0x0000000000000000000000000000000000000000	0x820910798bdb9b7885bfb7cf9bb37c70fd67e21a	7180.2	17643183.512623364390663678	3913364	9	0x6179c848ca56c50af417837417edb718964d331d6bf97c2dfbba6f46ac0c7b71
1129	0x0000000000000000000000000000000000000000	0x1d8c978410aef405dd66e53ef9fe9de63845af66	14.3604	17643197.873023364390663678	3913364	83	0x84bcdf4dc25c841462c61ef9e4ee272bbdf070135ee6acec7fab6486d8464fff
1130	0x0000000000000000000000000000000000000000	0xf3b8cbbeeaf1eacd6fac6d3bc0450b3736482f14	2393.4	17645591.273023364390663678	3913365	4	0x4d64cbeb9c9189f7a38333b498b74f25b6280026627a632a6226e46b9a2b8870
1131	0x0000000000000000000000000000000000000000	0x3337f7e282bee0a2e396f4415729972e6b01d7b7	2393.4	17647984.673023364390663678	3913365	13	0xfad39f32fe6a7c5d20d0cc4cd83731f0e9759fd8b014ab7c223555f312184a2f
1132	0x0000000000000000000000000000000000000000	0xb079a72c627d0a34b880aee0504b901cbce64568	3350.76	17651335.433023364390663678	3913365	19	0x2b5087368ecaa5137df2eaece52ebcd69d9fe26ab1481233fe2b74e5bce3b089
1133	0x0000000000000000000000000000000000000000	0x43744b52dd796ed0ca738e2185999745c0c1cee3	957.36	17652292.793023364390663678	3913365	33	0xb941f5ec909bcecb5207bdcca2c0b7f8e90e59c545172502ae1795001981877d
1134	0x0000000000000000000000000000000000000000	0x1b29291cf6a57ee008b45f529210d6d5c5f19d91	2393.4	17654686.193023364390663678	3913366	28	0x60b4ed3e12d2e65277e4f13148f0b5f4e0a596eb6fb420e760770a55c20b6a36
1135	0x0000000000000000000000000000000000000000	0x2737376e5878f489fc2d12c1466d836146bfb767	71.802	17654757.995023364390663678	3913366	33	0x8d7f4477ee34ca39e220251312ebcd8a64b3cf12ce0f36095e3033afee0ba864
1136	0x0000000000000000000000000000000000000000	0x50a79064ab68103167bd654fe7427bab94432aec	249.535884	17655007.530907364390663678	3913366	43	0x3721f1f8e9c8b56a2d0bd9cd85b6861e6d705fe4e0e46f6353ee2eb415ceed50
1137	0x0000000000000000000000000000000000000000	0xf6edf5dcdfba55f3cecee2a430bb6c2d30a4a1a8	1436.04	17656443.570907364390663678	3913366	56	0x73f23542a5db02145419dcbfbac13e9e9a01aad600af7ce580093d51bc8931d9
1138	0x0000000000000000000000000000000000000000	0xe3d9c207b6312b32b661469a84f2b6278c6c765c	478.68	17656922.250907364390663678	3913367	1	0x7b93ac53c337f735d90fd81feae031030c2a8d0bc246bdd0f0b25e2645f9258d
1139	0x0000000000000000000000000000000000000000	0x9146f63d43b504f011fc78fee77b9e8aad390150	430.812	17657353.062907364390663678	3913367	33	0xbb345aee1d837dd888ada97f775313f1c20eca51c9f1ef22d5719549d5ed95b1
1140	0x0000000000000000000000000000000000000000	0x0545d94f94b25619eb78058213a8663c47d99900	111.436704	17657464.499611364390663678	3913370	10	0x860b38afc86b4a330be70731779821312e1371a6732dfdc97568f2cb61f6332e
1141	0x0000000000000000000000000000000000000000	0x4e37a7dff5ed16042768fdfe608d1ec1fa62e507	239.34	17657703.839611364390663678	3913372	15	0x3c99fb248cdcc40d8913e486afb8a5246927c8e9ac1c497a4c089cfc0a87b4e4
1142	0x0000000000000000000000000000000000000000	0xd21219629a610016ad7b9a6cb3817b372f422153	57.4416	17657761.281211364390663678	3913372	71	0xb19321c7581c0053a54e572deecf914c7b5399101bbe3027dc4a2b5592237fec
1143	0x0000000000000000000000000000000000000000	0x98ed023bc8d6f3e911166d5d165be6cc6bea9588	957.36	17658718.641211364390663678	3913372	81	0xa6ae80a6c707af253819c18d0093838b7dbafad7e5a5a2d9b8adfa9017b9264d
1144	0x0000000000000000000000000000000000000000	0x76c5661c1c65820df706d67917a288c39a37f627	248.9136	17658967.554811364390663678	3913372	82	0xf642e6a5f37310e872449408ca13fad411938e173c831981cda128650b9c083e
1145	0x0000000000000000000000000000000000000000	0x40206c15485139280e87d5a95ccba77911ce1810	86.1624	17659053.717211364390663678	3913373	17	0x55613532413fba16e816fd8f34c4e3a959e19e6d39681b53f420a1d4f96ba206
1146	0x0000000000000000000000000000000000000000	0xe73a25b58bf440d8ad53eb773f412a4e89e22719	1148.832	17660202.549211364390663678	3913373	93	0xf8794b7f12170d439438a7a6a4cba951810be8f9f754a7716e0ef4d707945d89
1147	0x0000000000000000000000000000000000000000	0x7829094247ff3e7027d6a3bacde4f8bf46b45580	143.604	17660346.153211364390663678	3913374	21	0x63ba053216309ccd71c6d1e17872fc4076ad3ee31d7cbf27130b60eb6e7bfbf1
1148	0x0000000000000000000000000000000000000000	0x228cbb8ad6d795292ae39e528c418abf51464d5b	4786.8	17665132.953211364390663678	3913374	43	0x477bfc9accb82171fab031a259c15ae200566cfdf7f2bb184c27987a8dbe899f
1149	0x0000000000000000000000000000000000000000	0x95c891f82bed97e307e333820b899e02a992ce99	7180.2	17672313.153211364390663678	3913376	3	0xd1ed8f3c627728f34f6e2b36e97703ef5e14611015fde024d5d5dd71b25356a5
1150	0x0000000000000000000000000000000000000000	0x3833f8dbdbd6bdcb6a883ff209b869148965b364	14360.4	17686673.553211364390663678	3913377	4	0x7043e7c3cd2a7d90a3c958ec2d14e63284e653f963cf7679964cf5ef16a94b67
1151	0x0000000000000000000000000000000000000000	0x31cde94f920f82688251314f75cd5115e653d502	238.38264	17686911.935851364390663678	3913381	6	0x4efce4a51d4f756f5a6b7907311d2625ee8ac18ad2d579dfa6735525c1fb18cf
1152	0x0000000000000000000000000000000000000000	0xfd0315b6d5b8a2d8c73072fd105a285b1658a223	957.36	17687869.295851364390663678	3913381	9	0x70eb69e6dbbedc8463246518720843bdbd6618f2b4b233f513fcee25ffcbbefb
1153	0x0000000000000000000000000000000000000000	0x234980ec63009a686645749da99c68cd2bb4f91c	2486.26392	17690355.559771364390663678	3913381	12	0x9aad1e916b0dd5ffec00860972543eb79a97af877e35b0ea0fb013a7c90b5b98
1154	0x0000000000000000000000000000000000000000	0xdbf53199b14eef5063d456ccab9dc844ca6af453	359.01	17690714.569771364390663678	3913381	75	0xb8cff3a3c15608f02dd82244ec230e681b30e2e82aa5f3a786c40bcd950f461c
1155	0x0000000000000000000000000000000000000000	0x76436bdf4f3b3b9abfa08f825d2db471a4e33507	1866.852	17692581.421771364390663678	3913381	81	0x3e52629af726f0988e04a76923a9774ba5bbff88718c647e24e6b613ecd44036
1156	0x0000000000000000000000000000000000000000	0x5e0aa0f5b9adb5b147c895260dce10accdc70037	234.5532	17692815.974971364390663678	3913381	88	0xb567edfbd457ecc882d42f3191e2fa4da0e8bda1c7c0048f6c29fde5c467949a
1157	0x0000000000000000000000000000000000000000	0xcf68d1d234a94ce12aeefe2b1e3ceea6d20bf858	478.68	17693294.654971364390663678	3913382	141	0xfeba5082ea79d71274435aca6d7a890626a3f25239be6969cbb08aef19b972d2
1158	0x0000000000000000000000000000000000000000	0x4105b4343f4c52cea24d2cbda25b714c10bd0fc4	564.8424	17693859.497371364390663678	3913383	0	0x01e7f139868b2dca8dd82498135e53ff05b0834ad2d9af91c4445fd8a9298011
1159	0x0000000000000000000000000000000000000000	0xb5bb2f301b0175202595b87d1c9700f2e24684a6	1914.72	17695774.217371364390663678	3913383	12	0x4146b14914e47a2a738c83761bcc978f0075727b108d9a719a979d7abe5722e2
1160	0x0000000000000000000000000000000000000000	0xb1bb8924202b4932203a2de4733a95acba81a5f6	478.68	17696252.897371364390663678	3913383	36	0xf6f6e0ceacbfa63e00fa7b4f81ffddd7ccac60ec9b128c67c02f4115941257ef
1161	0x0000000000000000000000000000000000000000	0x2d3e3e232b8dc1fa9e862bbef90760ff2f18c0f9	495.07335396	17696747.970725324390663678	3913383	50	0x53007a53bdd027460a3d711d9419e44198f7dbf6c2e29dd84b2fdc6df5e3aae4
1162	0x0000000000000000000000000000000000000000	0x319b1affb3d244ca67719139faf6aab454d519ee	10.866036	17696758.836761324390663678	3913383	71	0x435f3bf354a998db117d6de526d9303bc185384b1ff801339d33f1698499ef47
1163	0x0000000000000000000000000000000000000000	0xfbf4c0315795c99de59bfe155ef314fab47f096d	1436.04	17698194.876761324390663678	3913384	36	0xe72eca3b3bd4ddd8add4977f7e1512db67751741c6e1944af7c2b7392bd463e4
1164	0x0000000000000000000000000000000000000000	0x1fa467889e55cd360e512456547e62ba9dea2a43	105.3096	17698300.186361324390663678	3913384	71	0x5705b970683b851712b743cef8a967dc11f9f6d9ec79b101c19a9505eef12c7b
1165	0x0000000000000000000000000000000000000000	0x43744b52dd796ed0ca738e2185999745c0c1cee3	478.68	17698778.866361324390663678	3913384	77	0x88cf651422a114e86c285dbdc490dfc736953e86c894fe0451973863bb9b6112
1166	0x0000000000000000000000000000000000000000	0x3aa5b1e7e608ab5f79001f773249357573e76af7	3839.49228	17702618.358641324390663678	3913384	81	0xeab7a2389e9dcedb31f13be17daca72db7b6b256a95acfb74600ac3090ee6cdd
1167	0x0000000000000000000000000000000000000000	0xb00ed10696e9a2b6388e7099a86e404bf03f7a38	478.68	17703097.038641324390663678	3913385	10	0xd1bd07e7b36cd212789d1b4fa21a2c6088899b6c1d5e310673e2161f4e77fbec
1168	0x0000000000000000000000000000000000000000	0x5cdb931930464c2c354f5c2c9627997a8f04e160	307.31256	17703404.351201324390663678	3913385	66	0x90f3ffa58bc9cdbabaee00d6506fe56ebacd7361f92294e91e8cb33ad56246bc
1169	0x0000000000000000000000000000000000000000	0x171c2309961b195231a6e656e2e35f296784c454	1.91472	17703406.265921324390663678	3913385	67	0xb1f35de63003a8ed50441ed6fffdc27e78da7642f0f554157e791fb0b6afa470
1170	0x0000000000000000000000000000000000000000	0x3e8d412c0abff2edca2a987149aa6aec7288912a	239.34	17703645.605921324390663678	3913387	2	0x63e6a1946fb8df6e00c0a500893b7d82dd7eb898846f8e105fe5144a6f83b560
1171	0x0000000000000000000000000000000000000000	0x38b2197106123387a0d4de368431a8bacdda30e2	3350.76	17706996.365921324390663678	3913387	18	0x0cf19796c22083124af8f671f55347a8e75f6aa808b98d7208c023408316a287
1172	0x0000000000000000000000000000000000000000	0x7829094247ff3e7027d6a3bacde4f8bf46b45580	23.934	17707020.299921324390663678	3913387	37	0x16c37d4e8fc9b5a5f42ee871669e0f0603637beaf6258fa74ce2b67dc3d457ab
1173	0x0000000000000000000000000000000000000000	0x72ccd6b9522e89d43b2ce931ff6ba92b8b77f136	526.548	17707546.847921324390663678	3913388	8	0x15d74fa2f09434f45670fa30655a06baabc9c90978342a391f9bd13c344bde99
1174	0x0000000000000000000000000000000000000000	0xc1b47acb5e90da487bb8e917505261ba649d3ea7	718.02	17708264.867921324390663678	3913388	15	0xdeaddf5183ea4c4290a1a6e47933c43f30039c3e40c639e1590419be16519e10
1175	0x0000000000000000000000000000000000000000	0xb996b0b6ca1de6520dd7a37cd551d130fe956654	957.36	17709222.227921324390663678	3913389	48	0x233e59255a1ea92699da97032bea2ce3da2822521509e49c9df160ada958c544
1176	0x0000000000000000000000000000000000000000	0x67e7e452a8671efecb9284c483de75c3ff1f02a9	628.5469677444	17709850.774889068790663678	3913390	29	0xc38bb733f09a2a3942dd3b286aa5a421793bc61227bce77401de09d9df9a364b
1177	0x0000000000000000000000000000000000000000	0xeafb84829fd3291bec1f12ea02f7f9db0ee13f0e	1914.72	17711765.494889068790663678	3913390	38	0x3fb4184c223e1799b02eb0805c4649b8fdcfc5f5d8afd559efa441d88dd360ae
1178	0x0000000000000000000000000000000000000000	0x54a105abf19547de568f56e2e945f7d5bfe32336	957.36	17712722.854889068790663678	3913391	9	0xdddb5eb059c651042f0c07d01c6c2fc2097db544fd8dad9a117a824115aea62e
1179	0x0000000000000000000000000000000000000000	0xfef808fb5d36d560e42f50e6e8dbaf671123bfc4	19.1472	17712742.002089068790663678	3913393	38	0xe3ca25b40cd688ed3ac8b1c3b76891cb17e308ba49573ec644948c1daab2555a
1180	0x0000000000000000000000000000000000000000	0x86cdfbb09209d0e064fe3b4c2e4216cd60ca0f25	957.36	17713699.362089068790663678	3913393	69	0x85042cf2c144c977fca6cfd12c1b4d0a047772ac80317d14ede5b86db8bb9876
1181	0x0000000000000000000000000000000000000000	0x48266e9e45df10ece3299575355d45d43e804356	478.68	17714178.042089068790663678	3913394	36	0xe21d9bc7a0369895f3992b5b2e1352b122b65dd3b60d139ec74ed31aed0b4a97
1182	0x0000000000000000000000000000000000000000	0x7a4f3cf71e8970bd2967e91a1b8efde80785a8ea	1914.72	17716092.762089068790663678	3913396	15	0xe07dd1ec26f0d090885f1a891dcc0bd61d48d058824f6e3b64c01334dc77eb86
1183	0x0000000000000000000000000000000000000000	0xb178bfe776bb2bcfb4016ecacbad41bc6dd037a8	10530.96	17726623.722089068790663678	3913396	24	0xbe6684926b12075044652dbfa9751049f1831be753069046bb48cee0bcbed2b1
1184	0x0000000000000000000000000000000000000000	0x001dbfd521940ae85ec235cc3027cb7242c9cfbc	478.68	17727102.402089068790663678	3913396	26	0xe7ce7fc13806c3fa8285dc3287c644712bb788863edde64295101b17b7df3448
1185	0x0000000000000000000000000000000000000000	0xb4848ed01600d5002e2cfd21d70fd7a77a7e81ec	4786.8	17731889.202089068790663678	3913396	39	0x6cd169bb4a1ed0f99dfa9c73e1c37ca40c3f89bc55db93b4f8de7b4791306c0e
1186	0x0000000000000000000000000000000000000000	0x94924943f960f55c95196f75b6c390116fc7ae3f	478.68	17732367.882089068790663678	3913396	59	0xae633f90f76f1f820f411a749363fffb86224e73e8f6df23538234978a1a8b2b
1187	0x0000000000000000000000000000000000000000	0x1e7a6f7c0b59d6b41dfe1850f671e08b384bd854	248.43492	17732616.317009068790663678	3913396	64	0x6ea00ace8cd2723f71184bfabf00c6c5d094b07261023cdd569cc2f92c3ce86f
1188	0x0000000000000000000000000000000000000000	0xa0df149a083b6c48a7e85eda7767a69bc66c2930	73.933992852	17732690.251001920790663678	3913396	70	0xe7d6c7ee5293cebf9c098e12098438fab34e95c998b57b68c1cf12af88f8fe28
1189	0x0000000000000000000000000000000000000000	0xdc09eb652d4568c3e22d176bce8f5efb12af7716	389.4383616564	17733079.689363577190663678	3913396	71	0xc3c6868bb018a5eb4eeec6821fc23657c3be39c8b185230ef91f01960cb8fc1d
1190	0x0000000000000000000000000000000000000000	0xd2b978c9187e69482931016fbcd0a078062e155a	516.9744	17733596.663763577190663678	3913396	89	0x18af6eea4003bfa15b7010a7bb1f9f27ad7dc9d70c12cf612d792d515e70c5cd
1191	0x0000000000000000000000000000000000000000	0x12a72800d8588d7cc95f1b381fb9589b299b7ca4	502.614	17734099.277763577190663678	3913399	4	0x15476f22de4928091f15bfd2f90d7e38324dbd325dd5f66ebb3b30e9e165b930
1192	0x0000000000000000000000000000000000000000	0x1ec0adbf12dfdb2239eeb9d320f78149ec2ab4e6	3829.44	17737928.717763577190663678	3913399	20	0x8e9f873370f1c3f4fd4532ada3f0ffbb22059efdced73bc5a787e5ed5b817f7e
1193	0x0000000000000000000000000000000000000000	0x49225fe668e02c1a65c1075d8dba32838e1548ed	957.36	17738886.077763577190663678	3913399	21	0x9277c4e20dfb8a1ffb76651a98a2dbc871fb5e161708abcde20470c050e2687a
1194	0x0000000000000000000000000000000000000000	0x44061be116a5cf4c9faa9c21077a7924da9cb99a	14360.4	17753246.477763577190663678	3913399	56	0xd398fe30731f146a36cd03383b508803da5b8954798fede4d33485e590bd4acc
1195	0x0000000000000000000000000000000000000000	0x3a2be3642a8c64b4b2884857dcfd7668c411ff40	16.27512	17753262.752883577190663678	3913399	68	0x5a41ee1b9da395aa073d55c4461bb9b3ad26383f29484d5d303f70224c7527a1
1196	0x0000000000000000000000000000000000000000	0xe7679523f6a9de3a79246d3cefc92169d0989f8f	9573.6	17762836.352883577190663678	3913399	70	0xad5496f5e7bd0a4a5b7884f3bb8cb694f549cdcd0ad4223227ce50308f564861
1197	0x0000000000000000000000000000000000000000	0xfdecc75edda6a0d13c7ef41e49493cae742875f8	239.34	17763075.692883577190663678	3913399	74	0xd6bc33641aa67b5b34e5d844673d2591c79448aba72409682951e87c8ccfb01c
1198	0x0000000000000000000000000000000000000000	0x0715d083afab944b82dfd9f46d8fc487b5901e94	478.68	17763554.372883577190663678	3913400	25	0x21c882d53496c3f22310928c60a7e4e67a7ca2b4d1b4c6440607a07292f48423
1199	0x0000000000000000000000000000000000000000	0xb051ea9a11803c74270791a1e66235b77e26cfa3	1148.832	17764703.204883577190663678	3913400	33	0xa61fd81575a6aacd002f64453864e169610f23a796091f28e09dca8f8794ce2b
1200	0x0000000000000000000000000000000000000000	0xfc7324c9fb0dba66cb0f82dd887f7cd64071a734	430.812	17765134.016883577190663678	3913400	40	0xb31e7550fffc18e1e62ee6b555b3ff178e5952120419c3297cc7147c12fb47ab
1201	0x0000000000000000000000000000000000000000	0x0e3eff5c8c094e19a3c8bb4bcc44406f9e54e295	239.34	17765373.356883577190663678	3913400	43	0xd1a83e4c72efe3c519e3ffeb1c3b9ade9cd552807351aaf67b9b3656912e17ca
1202	0x0000000000000000000000000000000000000000	0xd2b978c9187e69482931016fbcd0a078062e155a	43.0812	17765416.438083577190663678	3913400	65	0x31480fa0c0f627399e511ba5a9914034850ffceac987efff5ba06a1161989b49
1203	0x0000000000000000000000000000000000000000	0x2647cc9e55dd93599ebfe68ad763a45cd1c3e3fc	1148.832	17766565.270083577190663678	3913400	69	0x2110dc4721d2573c3be1d5b0258373ed0a34f145bd897f658d89ecf4ed80403b
1204	0x0000000000000000000000000000000000000000	0x1cf2a2d22e8ca39ddfcf481039601f5ad74a8e8f	478.68	17767043.950083577190663678	3913400	74	0x331f7d8a3e54af374970eba9d7586129147f75cf97942742751650df8f2c9766
1205	0x0000000000000000000000000000000000000000	0x1816dddb4ed2a96f99c3ec5aba218eed503b148f	440.3856	17767484.335683577190663678	3913401	52	0x480677b6b7d6a138a1d45f5fd8218d2f1687997d7284cdca508fbe318b7bdd9d
1206	0x0000000000000000000000000000000000000000	0x17e0975ad70007c2701bb8131bcb7dccd107cd4f	4786.8	17772271.135683577190663678	3913401	53	0x54be4b95e18d67b768beb698a2b9756c7f721d6a738f2b85a6ebf67d4a886a6f
1207	0x0000000000000000000000000000000000000000	0xb33841ab8e4fc931a294256066286270a77632cb	239.34	17772510.475683577190663678	3913402	2	0x95db69ca3281da38afc780798d2c68637d319f144ed0c0eec1d9265622d4468f
1208	0x0000000000000000000000000000000000000000	0x579e249ad6e5095bc62dbb7cad81537fc3bd3748	4786.8	17777297.275683577190663678	3913402	31	0xe862d400c1549137e8f68bbf4093b7646f3371d27e59b7b81ec3988616258644
1209	0x0000000000000000000000000000000000000000	0x54b1738f13b8e7f2ddfaba4ca72762730fad6d23	957.36	17778254.635683577190663678	3913402	54	0x9e2a577eadf00a4ace1e5bd677677285279980a26831cd2d7f003f8e03567a91
1210	0x0000000000000000000000000000000000000000	0x24820240d712aa75f5fd4d81f51befd58955fccd	478.68	17778733.315683577190663678	3913402	59	0x1347917b177da72bc4acc1c047ac1cfb608d53f3f034c9d7a1ec10ceb11a1dbb
1211	0x0000000000000000000000000000000000000000	0xab95a788e97b046fc98202b28a159619f1fb2b07	28.7208	17778762.036483577190663678	3913402	69	0x6be303e81e94571937c11f76aa12ca69471a4c72ba5a05729427bf7f5cc459b0
1212	0x0000000000000000000000000000000000000000	0x0405a86a321b07df7a796e04fd5acfd1507dd773	23.934	17778785.970483577190663678	3913402	71	0x8131080dd59df30fc8caf4dd2a6789bd1896c382e10a729c2ee4798ed0209214
1213	0x0000000000000000000000000000000000000000	0xd95099f11901d21dd7c0d19b91e13c4bba6b2b64	296.7816	17779082.752083577190663678	3913405	3	0x1814b7725eab1d60620738eb45e61eddf6b78488183647730d180e1a5d265df3
1214	0x0000000000000000000000000000000000000000	0xa16864c8eac411f3ead5f02590cf50f777103c24	957.36	17780040.112083577190663678	3913405	5	0xad430d6d3489b7d1f60184b1b7ed9fb6ca2f679f0dcfacd34eb6274f0645c59f
1215	0x0000000000000000000000000000000000000000	0x9ef171a8c62eea6455830bde5de99db5a7ca5119	62.2284	17780102.340483577190663678	3913405	7	0xe9693e149f62fb6a9f03a8506be128a9615e339faef173a02ca979bc54fd1ed1
1216	0x0000000000000000000000000000000000000000	0x880b0dc7386f302304b752c5a52535a6c9d9d91e	1431.750883596	17781534.091367173190663678	3913405	17	0xa64d738b581203d07b265cc701c8e6f0a6e432b1c953a7b787ab92ce20286eba
1217	0x0000000000000000000000000000000000000000	0x17581b62da870a929d68af4b0d2422000aafda10	277.6344	17781811.725767173190663678	3913405	58	0x020cfe3b40c4db74e7be44fb2452b08cc36cce56c647d6358eeb7d6f136fe76e
1218	0x0000000000000000000000000000000000000000	0x68b56fc0640053defa16239d1c7ad8e540b4d519	239.34	17782051.065767173190663678	3913405	63	0xa654b7d0e9ea7cc1d0d9640c4abb5b778cfb813db234bb827bc9d6ac03be77ac
1219	0x0000000000000000000000000000000000000000	0xf428237037e5c0acf0751f9b42b83d7b4903d305	753.2759834868	17782804.341750659990663678	3913406	2	0x00e04109bf2508b940694ace31615b2d2c09603012d0b593bfa38275af68f87f
1220	0x0000000000000000000000000000000000000000	0x8e21841e17a4e432ea92c99d209a96cee55b66a4	239.34	17783043.681750659990663678	3913406	22	0xbdee670950ccc5f1653b9e4eff55dcba62a8e093fbe7026d571b571771e18080
1221	0x0000000000000000000000000000000000000000	0xb9a5bb71af4a1bcefeb59e58e84357b1692fd944	4786.8	17787830.481750659990663678	3913408	4	0xe7fc19026d964f3188db07756af6f795a7d8acda2833a03c1943fd15eb66a07a
1222	0x0000000000000000000000000000000000000000	0x0b48dda8aa67bb7aba73e67a0c44f213e883e084	5744.16	17793574.641750659990663678	3913409	8	0x23d3f08145008abd38b9480833b552bac31701c3ab6400353104b55089465c73
1223	0x0000000000000000000000000000000000000000	0x0c2ce00e722bd42048c429842f9e1aaf42590140	478.68	17794053.321750659990663678	3913409	16	0xf91d95882233f0ab0945941d7e8cb90cd4e7fca7e24ddc18ccf28cec6f5c4453
1224	0x0000000000000000000000000000000000000000	0xfcf6a9cf887f82d9de25182dd7a2c0f26c70a8b9	718.02	17794771.341750659990663678	3913409	19	0xf4323e9fb8f3a836873db8a1d60b9ef460909dba3bacecbb7330d390f0538a44
1225	0x0000000000000000000000000000000000000000	0x8ae03fa94a53128aecaaa3dffb87fca97797c1f0	47.868	17794819.209750659990663678	3913409	41	0x464e561c65ceb44e1de7c49117223067829041ac989ed3fc036de064a24485fd
1226	0x0000000000000000000000000000000000000000	0xac364da81a79cf1b9ef93a6b6ac0e68d7dc01b6a	478.68	17795297.889750659990663678	3913409	81	0x3687fae693b9a54875662922f061c37e74dc4cb57ddb67a1821ec0585157df60
1227	0x0000000000000000000000000000000000000000	0xb9a5bb71af4a1bcefeb59e58e84357b1692fd944	2393.4	17797691.289750659990663678	3913413	1	0x775438daab9dbcaf7788791c6eed8458ba2fdd7f067b9584cdf36b22646a67d9
1228	0x0000000000000000000000000000000000000000	0x8ae03fa94a53128aecaaa3dffb87fca97797c1f0	478.68	17798169.969750659990663678	3913417	2	0x4a1a696aa1f760aa0dfc5222826ceb838258d0ba1eef69afb03fcc2a10f80791
1229	0x0000000000000000000000000000000000000000	0x7445202f0c74297a004eb3726aa6a82dd7c02fa1	478.68	17798648.649750659990663678	3913417	6	0x538aff9d4eea08390cbd401a3f688caffa5a872f096d7057e732d20e1b9425e3
1230	0x0000000000000000000000000000000000000000	0x5782c87e652b3e21a4be17b20fa83fe4844280d1	143.604	17798792.253750659990663678	3913417	40	0x944930ae81b0e447f079edafaee05ee9cf72a1a4cff87402c1638c0af88d24b9
1231	0x0000000000000000000000000000000000000000	0xd682bda378e3b635d28effd8a2a662d48ecf115f	1914.72	17800706.973750659990663678	3913420	6	0x722c26290453ed7feffeed2ae3ccec5a5b5aa66bed0bea8ee0a9f4dc1a157819
1232	0x0000000000000000000000000000000000000000	0xb3f636cae9e8ad9795d14d3bdda3e382dba47c73	124.4568	17800831.430550659990663678	3913420	46	0x74250580a616da213711fcc389b64244378557bda1f5f6fe3e2365f5582e5732
1233	0x0000000000000000000000000000000000000000	0xa7c89d24da721db34ec7c544688f58ea3bb6591b	7.65888	17800839.089430659990663678	3913420	69	0x076fcb7ea787ebdd39dce82cddc38f51be0f27351cd718f62c2479e6070e38da
1234	0x0000000000000000000000000000000000000000	0x251793b81538505f44a4b65f66bcc7e16b73a9d0	957.36	17801796.449430659990663678	3913420	75	0x2e176e2686216579df0512e27455192e3d17d9b77130fbfbc5eb51fdcaf5fa3f
1235	0x0000000000000000000000000000000000000000	0xe30c0cdc7ae455d92e4cdc72d90baf2a6e101106	239.34	17802035.789430659990663678	3913421	8	0xd11d63b17fd88362b7db055a3e3357f4444eb3d2ec91a5057fd3a6c7cbc95d76
1236	0x0000000000000000000000000000000000000000	0xdaa146bce939f82d1f6a4e7d3d12e8d698fe2b99	957.36	17802993.149430659990663678	3913421	14	0xd384a89f9bc36359ece0fc454fb1fbfb30470e4db8db16d8310d6ef08a740d4e
1237	0x0000000000000000000000000000000000000000	0xb9a5bb71af4a1bcefeb59e58e84357b1692fd944	478.68	17803471.829430659990663678	3913422	0	0x12b25b33eca39f4c845d5ee28de841ee1397f98d5f75503efb90221efebe43a3
1238	0x0000000000000000000000000000000000000000	0xb0d63daf16875f97ac8efbb1e8eab992e65fb2d6	960.71076	17804432.540190659990663678	3913422	32	0xaecae3eb00b72aa5c6b63fbbbb1a0aaeb6a24275e30dd65d96404b3842ae6b47
1239	0x0000000000000000000000000000000000000000	0x0405a86a321b07df7a796e04fd5acfd1507dd773	191.472	17804624.012190659990663678	3913422	49	0x5b0e7627a812323cddf0160b31abe9f0849ee1d2469edb60ee7980356f9c9984
1240	0x0000000000000000000000000000000000000000	0xe30c0cdc7ae455d92e4cdc72d90baf2a6e101106	239.34	17804863.352190659990663678	3913427	9	0x697c1a68379ffebab5d33ee74db991061d35f9fcda41cb862967b48016ef6006
1241	0x0000000000000000000000000000000000000000	0x4acde93f6dca156fa4cd73f6f9de4ecaca690770	2393.4	17807256.752190659990663678	3913427	11	0x2fac16602b8bbc33a38e499153161b94ace4f3360ac1cb88549f06c94c8846a1
1242	0x0000000000000000000000000000000000000000	0x4c73449dc82bb718e4fe1a1c3fab09b7950a7dad	291.9948	17807548.746990659990663678	3913428	15	0x1d56ebb0d34b9211d853338d5b41b9140c09505376a0aab1e268142edc77ab59
1243	0x0000000000000000000000000000000000000000	0x31cde94f920f82688251314f75cd5115e653d502	952.5732	17808501.320190659990663678	3913428	16	0x56c4ceb89ebcd2ad813d49e474e69547e3c7048c02913323f777274f3ff4beb6
1244	0x0000000000000000000000000000000000000000	0x0055fdeebdd52eca3ab1af6288903f49cbc60414	7180.2	17815681.520190659990663678	3913428	25	0x568822a0d5d53470c84ef2feeaddede00e846536910a66be3090dfcc91719fc4
1245	0x0000000000000000000000000000000000000000	0xb4848ed01600d5002e2cfd21d70fd7a77a7e81ec	7658.88	17823340.400190659990663678	3913428	46	0x1680e2e49ad41d3abf59db602bb8695d4a5a032a2d5c4e61dec7b1a387068e2a
1246	0x0000000000000000000000000000000000000000	0x5c2f2adf56544bb8cc08798b9262d3fef5b6c03d	4782.0132	17828122.413390659990663678	3913428	59	0x65d0db0396a499e47b6228f3b7f3a186c3e9572f3b70d52563503c731848f6d0
1247	0x0000000000000000000000000000000000000000	0x4656f59ce56e7b16cabfefd387560c0be0c4c728	239.34	17828361.753390659990663678	3913428	74	0x69a8059d65c9f2a7d2e8ce561b0418a153e0cc8f612f52d3bf77792038ea26d6
1248	0x0000000000000000000000000000000000000000	0xef710c3f999d9f67b557fc0091edc5f687971fef	957.36	17829319.113390659990663678	3913429	29	0x0ad81c182e2c62fddc5e8ecac94e466b96a199e707c952ba1b58d62ca6b9f12e
1249	0x0000000000000000000000000000000000000000	0xf7b9faafd60cd9d510979bc7e453bdf4daee2250	478.68	17829797.793390659990663678	3913429	30	0x2b93072f7354de994b78da4ac0bae7f5cf54f99aaa0ef0b650836b71862bdebc
1250	0x0000000000000000000000000000000000000000	0x5eedc8c576f33bfce795f8dc10dda60ed06014f5	239.34	17830037.133390659990663678	3913430	1	0x1066341fec880ed96a7f1b2f28dd265061cbfc483be9d3d39a94203b6101674d
1251	0x0000000000000000000000000000000000000000	0x52284b841362691e77545fa9c65feae2d8b7355d	430.812	17830467.945390659990663678	3913431	22	0x368ee62fbd8ab92cb7e7318217cb96042fb667c50b712294d5e3b2722f2c1b97
1252	0x0000000000000000000000000000000000000000	0xc4fd76527b6b455b540a033c5c6cb61ff268664b	511.23024	17830979.175630659990663678	3913432	32	0xe74b13b5ae2252ef8c2103090b1c076a7fc23507c2f3531f46e53c3e5d9d1c88
1253	0x0000000000000000000000000000000000000000	0x9320a37b4aeb814ddc669498089cc1530a35ba41	478.68	17831457.855630659990663678	3913432	33	0xea2fb09144ae58873a507fe85edd787fdd10f4eea215f2290684b7bc63999cce
1254	0x0000000000000000000000000000000000000000	0xfc1bb70db33436eca210bc6562d91aac15f8ea36	40.6878	17831498.543430659990663678	3913433	22	0xf20139441a4260793d7bfa9cbf8c891308d554c68d393ce0228900b7491c17bd
1255	0x0000000000000000000000000000000000000000	0xa672cefc00403a2e9c6e71de8188cd52cf36ff4e	3829.44	17835327.983430659990663678	3913433	25	0x0ef5bae845a1a1ed50f1dbe30f064df9b1d0bf3afdbbf6db3806a6273080887c
1256	0x0000000000000000000000000000000000000000	0xe5d505e7836f3397ea35837ed8a9e5e36d80d88a	23.45532	17835351.438750659990663678	3913433	42	0xfdbceb3776fb67fef99b56dca9e427b0535ad42d732586e155f3d78c6eb146b5
1257	0x0000000000000000000000000000000000000000	0x430f08efbbe6f6cb02578935f343a40b88ff5899	2393.4	17837744.838750659990663678	3913433	70	0xef050d79f2bc9e96b96b5e9b7c736902c2aa58618ffef517fb7d4c08b254469e
1258	0x0000000000000000000000000000000000000000	0xd3631bcfb9a9dd56e1e979007f6a139ee6d4fcde	599.0055666204	17838343.844317280390663678	3913434	11	0xf20676eb378d4bbc2b0144dc86a8b27b949f7d573c79167f9f3a25d7bdac12b0
1259	0x0000000000000000000000000000000000000000	0x3f53d7422ee77809bebfab45461b9b967acf6e32	477.914112	17838821.758429280390663678	3913434	27	0x4096685725b4a05ec415e7fc1e77ec6ce8dcd56a00143e20cdccca548ed04bb4
1260	0x0000000000000000000000000000000000000000	0xca4ad3d429ea5130512b0ebb7fa4a7fa6d1a0e41	1436.04	17840257.798429280390663678	3913435	4	0x21c49e9b49ce2cc73709a360eec9d7fe72afe8fde0f85469c65b8d9977e80d84
1261	0x0000000000000000000000000000000000000000	0xfee3bf7fa06194cd5794d76b13213bf5d0a1b0ae	1436.04	17841693.838429280390663678	3913435	23	0x3a78089815bbffc6661cf90008c5d6be8e0df4196d06cbfc005d3c63c4caf7b8
1262	0x0000000000000000000000000000000000000000	0x63db17d372c1e6ad23f49bf7b2993cc8af482e91	19.1472	17841712.985629280390663678	3913436	41	0x426a546622d6644a50f8366760c43cf4a324f432b6fb4333767afacaad2cf2e0
1263	0x0000000000000000000000000000000000000000	0x703345bd09915d0cf19444246657e36d868598eb	239.34	17841952.325629280390663678	3913436	48	0x3c9b4a90881b9ae6271e0266209e4f00ee3e8a2135cda0ea32d7961a34237e27
1264	0x0000000000000000000000000000000000000000	0x969ed662df39b3652017ba6f9a48b161bee3cb8a	957.36	17842909.685629280390663678	3913436	49	0xa0fc045b4b4a9b28f6ad6e9bf2e8fef82296fdf241092a8c0550c9ebf4a16f0c
1265	0x0000000000000000000000000000000000000000	0x6f6c7b473dd7b8e159564cf596629aa4d226c8f4	1436.04	17844345.725629280390663678	3913438	15	0x1c5db97d47b8672d2f9c52d8ddc377e55ba82690d34b8dcfcb42d4450837a292
1266	0x0000000000000000000000000000000000000000	0xfb9a79d649b742fef6e1f7c036987198e2283162	1029.64068	17845375.366309280390663678	3913439	13	0xc984b6cd48141f4fa27e14d65ca6287ea8c234c8b4e52ee94ab5cde6ad2ae4f2
1267	0x0000000000000000000000000000000000000000	0x664f816d1cddbd3fb1128abb2fbcca757baf7ef9	957.36	17846332.726309280390663678	3913439	22	0x6e35a02d1ddae3c90d6729f0c76c246ab7332de059a3cfc487b86b4aab794da4
1268	0x0000000000000000000000000000000000000000	0x8aae50113d811edf6653ee28a779cdbd2a783707	2194.26912	17848526.995429280390663678	3913439	70	0xc49e481d918a349f4d3ad12f1a7515e1616713cace458eceb325e3d476b6c339
1269	0x0000000000000000000000000000000000000000	0x99ae0a287138fa3bf6138c55648e9e338f2d531f	1184.715345769104129601	17849711.710775049494793279	3913440	48	0x9e9c1f07b6b9b3cd6380581284a253a0423d1d04efcee575d23d43608ef91df3
1270	0x0000000000000000000000000000000000000000	0x3310406122ee607463c844ec61fb38222ee06c5d	191.472	17849903.182775049494793279	3913440	55	0xa8143cee7fc034347646343a49bbf7fd61ea49e7d167b07bfa1cdafddfe75607
1271	0x0000000000000000000000000000000000000000	0x3381b2e75086d113daaad7bf7434f8332331a348	4786.8	17854689.982775049494793279	3913440	56	0xb8a46b3b4b75fb318b58a15e7d16892d46e4a90942379d0635160b1281c046a3
1272	0x0000000000000000000000000000000000000000	0x44494ff52ca8be58a80fa8ad5c2055237d860155	718.02	17855408.002775049494793279	3913441	19	0x39011b7fa39618e034044bc103d8c677bacfb94a4308e4a08e6095df376b6c07
1273	0x0000000000000000000000000000000000000000	0xd47f98b39907f344ef058f6561d5bc0fd42c6740	785.0352	17856193.037975049494793279	3913442	19	0x1630232273f8d1f4cb9d19c3e6b395ced4844fed646ee568da25c10857d8ac42
1274	0x0000000000000000000000000000000000000000	0x235d6e2d599df935da847b5662443653957d14a1	1064.58432	17857257.622295049494793279	3913442	22	0x48e380bc52067017f58e39f5b91eae8664401703b52febdc1c73ea8ac7f893f5
1275	0x0000000000000000000000000000000000000000	0xbfc78690734ca9955a8c883e9918b80b7d1d9c08	478.68	17857736.302295049494793279	3913442	30	0x7c93f95a0c51193563560ace7303df8d79a4e2d4dd281a3c7c75261943da40ba
1276	0x0000000000000000000000000000000000000000	0x70cfbb2b250ab7066916955fa3efd3d264239151	550.482	17858286.784295049494793279	3913442	36	0xa56e1593c990fe2c10d94df2c78393930e11dc04503e97ee4afd86811edd6271
1277	0x0000000000000000000000000000000000000000	0xbc75d134d4ed07961c97b8864474436798bb97f8	3829.44	17862116.224295049494793279	3913448	4	0xb4b215189d2d5c0b4f642d8fcf82593a7a0a7a4979c5c9ed9618431fb9172ca5
1278	0x0000000000000000000000000000000000000000	0xd100af110d1a9d4968ba5c765aa37cc95a2c6ada	957.36	17863073.584295049494793279	3913448	24	0x6bcb4a14c5e6ecf6ad21e99a2bd1b00f29731d9e824034c1839b74e90d66feb1
1279	0x0000000000000000000000000000000000000000	0x57481d000ac8cdd965c078d79ab9a4be4093054a	240.488832	17863314.073127049494793279	3913448	26	0xcd1f3f66c52afa55a8b8808a98c3e52a185eaf7942aeb6abdf5b58283e9adfc2
1280	0x0000000000000000000000000000000000000000	0x5eedc8c576f33bfce795f8dc10dda60ed06014f5	14.3604	17863328.433527049494793279	3913448	31	0x32b8430ca8090d667d62bcc640a3f82ad40a83797fec587cd3c63d197a5785e1
1281	0x0000000000000000000000000000000000000000	0x00569bf1b519f582da8ed39ed020b160dfede520	478.68	17863807.113527049494793279	3913450	53	0x13ff5e35dfa3328845fad48ddf3f856a516e762b4d1ef42e56c3ade9d1c5672e
1282	0x0000000000000000000000000000000000000000	0xcca14b4db84295d1ee91ea849e1da17b2675f215	478.68	17864285.793527049494793279	3913450	54	0xb3cf119eb15c8f735df507a42f57ffd5cb9e71429e334ee1123ea2843d0fe754
1283	0x0000000000000000000000000000000000000000	0x90ef7500c348a43d71b447d56f91f2a7bee27ce8	2393.4	17866679.193527049494793279	3913450	59	0xaac33557313fea818cec9a6b13563a5b74b6855dc2a9547e0d6df3c7780e2f22
1284	0x0000000000000000000000000000000000000000	0x40c2f3eb1bbf212d1584e7059b25424ea693a17d	478.68	17867157.873527049494793279	3913450	64	0xee5e491617314dcec6c7ec6505992744e184386fdb4ee3df5264bcfcd1030f2e
1285	0x0000000000000000000000000000000000000000	0xd09bc98c17c95b6786436feabf16642c5b882eb3	14360.4	17881518.273527049494793279	3913451	13	0x18eb9000b8b5c0afec90a5b2886dc8f80010875b8408ad62e5585719b7ee6dad
1286	0x0000000000000000000000000000000000000000	0x8ae03fa94a53128aecaaa3dffb87fca97797c1f0	382.944	17881901.217527049494793279	3913451	28	0x572cf305a4a0e30a2b8e6418547e300b2763f224fbac2cbf229ea7412d59c179
1287	0x0000000000000000000000000000000000000000	0x4e2b10fdc68fdd35bb85909f1727fd90f4df0795	119.67	17882020.887527049494793279	3913451	33	0x010b73b6984313e33f5fac9ce5d4485569449a52a6fdb4e4beedd774da72c4e7
1288	0x0000000000000000000000000000000000000000	0x7d41740d6772fd1871a9909a66ec71d4bf7fd51e	526.548	17882547.435527049494793279	3913451	34	0x7013d0805b8587dfe494a06a5f8138aeeaa2a0a6455904e3d89a0d16d80a73ec
1289	0x0000000000000000000000000000000000000000	0xd1193c7b592482e275024f5cb0a16cfdd62d0afd	1196.7	17883744.135527049494793279	3913451	35	0xa4fe4eba7d2466f8489e2d371cebe37ec7673f28716c6d1774257aafe874a560
1290	0x0000000000000000000000000000000000000000	0xb62501495f4143435033bea49e8bd7fbb8b47430	2393.4	17886137.535527049494793279	3913452	2	0xb4842203ec892e5a7e71d53e383cf94c6c6b632c81bc1fd67c56769dd0755ec4
1291	0x0000000000000000000000000000000000000000	0x05683848c6b06b18f2aba5ed01ecb6a9a8108a3e	957.36	17887094.895527049494793279	3913452	7	0x67b77dd38a9026b2911515778072e2a158c19baac401f4903d05358713fdc949
1292	0x0000000000000000000000000000000000000000	0x0ac6178df3a1c6910239e2e6e917465735e0ade0	47.868	17887142.763527049494793279	3913452	21	0x8127cb029f34ed96fc6fd7dc635f6cde5887c7809efab7c5cf2bc88fe6457472
1293	0x0000000000000000000000000000000000000000	0xdf1718d37ed7579242ccf4f2160d09685eaa9e2f	593.5632	17887736.326727049494793279	3913454	14	0x98a8725b74e35c765d6ada03b8f5291ff475747669921d38fe00f8ec34578378
1294	0x0000000000000000000000000000000000000000	0x54735d8666d9e84376c910f2e32a4af79ee48120	4308.12	17892044.446727049494793279	3913454	18	0x735189dd3009f1ab746bcc8ca8292884b332241c919f8bfc96937f39859bbfa2
1295	0x0000000000000000000000000000000000000000	0x1cf2a2d22e8ca39ddfcf481039601f5ad74a8e8f	84.1554718716	17892128.602198921094793279	3913454	19	0x76db93f0eb87c21d08a115b78c2bb657e8a540cec0cf8a6f71574f393fa9474c
1296	0x0000000000000000000000000000000000000000	0x489b88d42628fcae059018d47aa9dba420c9abd2	432.08135596512	17892560.683554886214793279	3913454	56	0x87a40f7399658aeeaa57d91ae90cc23dab150c35f7ebcc0a2a64c3b109c17195
1297	0x0000000000000000000000000000000000000000	0x002848284eb655a5a99250ffbb09605b8e624261	2393.4	17894954.083554886214793279	3913455	1	0x67777109783cea487e29085b7b06cef5c0167893e0809b039ebde648425c26eb
1298	0x0000000000000000000000000000000000000000	0x0050ea391908166f958112183c709b4aaab168fc	6940.86	17901894.943554886214793279	3913456	2	0xe3cde19a4c1b642404a2c9e0b5811dee6af9655c20dcf5f69a6b1442c9010f5c
1299	0x0000000000000000000000000000000000000000	0xe3d9c207b6312b32b661469a84f2b6278c6c765c	473.8932	17902368.836754886214793279	3913456	34	0x68404f93f10050f019970ebe2b1e3f0ecb2b271c0bd42fd30f64fa4c5a537315
1300	0x0000000000000000000000000000000000000000	0x68665558a5c0d302b20bd8142dcdf3a59947c34b	258.4872	17902627.323954886214793279	3913456	49	0x0efa7de6d0269816c2b12524f6d6e70bc84b8b84b48cafef0ac071e571800a99
1301	0x0000000000000000000000000000000000000000	0x03fe00d55a4af6510fc2de741574a86608d1117e	80.0959303956	17902707.419885281814793279	3913456	57	0xfca49301d2a8edc21b50ddef1e5c584d1862548ff373f0112bceb5a9f9cd021e
1302	0x0000000000000000000000000000000000000000	0xb7edcf7b9f545bb267efeb44c01ca811f120d122	478.68	17903186.099885281814793279	3913457	4	0x21370245410c8a53aa69b8d0fc8780e2643c3d35213228a800cff4254b96a613
1303	0x0000000000000000000000000000000000000000	0x2553a9aa6cdb203895a904e98f6d2437be0805ce	461.9262	17903648.026085281814793279	3913457	7	0xdf9d14a3524f505427de9dbde231a05472e630d3190b0fb9dceb0b3ba2ce8c89
1304	0x0000000000000000000000000000000000000000	0xa16864c8eac411f3ead5f02590cf50f777103c24	718.02	17904366.046085281814793279	3913457	12	0xe7cc9832f9b77c6f3476351245117f54b9e6f2911968e8799ca5ff540d8aad93
1305	0x0000000000000000000000000000000000000000	0xcc369efcda35691cab9aab0ac4ae87179a5b5567	9573.6	17913939.646085281814793279	3913457	13	0xe9a1e7b02cbb41c4e14b29bcc7e012c9a8fd05c92c678d4d54fa639167a857ed
1306	0x0000000000000000000000000000000000000000	0x44494ff52ca8be58a80fa8ad5c2055237d860155	478.68	17914418.326085281814793279	3913457	30	0x8d4339fd9765761f0df68af7a9ea0741ad80451f76b863edc776cc13426c29d6
1307	0x0000000000000000000000000000000000000000	0xf6af742d17e9fbf123332ecc88c079eb2cb28518	188.231444103	17914606.557529384814793279	3913457	63	0xbe8242da063cead9497567a1f5eaed5f39b0f382684b53ea624b84e968b55149
1308	0x0000000000000000000000000000000000000000	0xa0fd28192487df8e328fa9658d0d71de333514f5	714.8823028614	17915321.439832246214793279	3913459	75	0x4d76e61425eb4c98dff231a8810db558c53ebe2abb03fa157ccdea3ac1cf3367
1309	0x0000000000000000000000000000000000000000	0x4d42f2598fdb3f15a22ed80b0d9014d235cd687f	957.36	17916278.799832246214793279	3913461	1	0x9e4cab26dc7caf1025b5925cf483ef230b93160682a1877757c40f2cc8eff0a9
1310	0x0000000000000000000000000000000000000000	0x0da8b8ba342526c661bc04d64420d7f224e16df8	478.68	17916757.479832246214793279	3913461	4	0x5db6246dcd6fd3a11b129b00a34b46412985299dea6634cb19e4139de862a706
1311	0x0000000000000000000000000000000000000000	0xdef1582848206ee65535db4a3cc52058fe54d1ea	478.68	17917236.159832246214793279	3913461	30	0x8a214d0a681d1959162b61fa6cd00b7810a0ead319b19159b087572893bd022d
1312	0x0000000000000000000000000000000000000000	0x31a204f032d84b4a20913b3f9954a5e5b731108d	239.34	17917475.499832246214793279	3913461	31	0xe197d6e65bb109996cd834daeda5bd12d500420c7dfce3a4c58d0bcae8fd1a78
1313	0x0000000000000000000000000000000000000000	0xa5659c0a37a63c2cbada7264ca08cd76ed06c347	6701.52	17924177.019832246214793279	3913461	32	0x9c74b3c0c3fe7898f49025270d131a87a652a4846ea613eb4a4d755b5d865635
1314	0x0000000000000000000000000000000000000000	0x6994094171e0fd59646e9b22937552fee6b8ccb5	1842.918	17926019.937832246214793279	3913462	5	0xd51fa6fbbe42c8597089d9cd9ee855bde91a6962de61b6e6a47ec7f14887d197
1315	0x0000000000000000000000000000000000000000	0x9d09c0c4993129080a0824d7da11ad1e685e725b	2872.08	17928892.017832246214793279	3913463	38	0x828e6cc590b0394c12736bbcb61eae50e53d7e8ff7b0d4f12f871ad072058be9
1316	0x0000000000000000000000000000000000000000	0xdee68c8b5b594feac6eb5fd761a058c728a42476	143.604	17929035.621832246214793279	3913465	15	0x13ed285312ad82ffcbf41c659fa35b10b6d30c3d35af29c346cb34ed9aeaa4b7
1317	0x0000000000000000000000000000000000000000	0x8bc1363170fc21ff1aab1d7049cb4f1d23934b8e	957.36	17929992.981832246214793279	3913465	31	0x9cd4c2af03f53bb1ed6eb8913820eeee9c656fc3ae73262d9a718fdb6e25bee5
1318	0x0000000000000000000000000000000000000000	0x266a3d6cb62429262cf8507103a40168d88fca6d	62.2284	17930055.210232246214793279	3913465	60	0x5fa6482d7a67e6900d5e2e46aa0302e2b9363f874f0998e37a25bb157cd448d2
1319	0x0000000000000000000000000000000000000000	0xdb2270145b720d2f9180879cd8bbf2879aedec3d	478.68	17930533.890232246214793279	3913465	73	0x9b27df786316e88a7cb7659ba64d09b8e5eb66ed968db248d5e735e7360b1393
1320	0x0000000000000000000000000000000000000000	0xf15e47be994d89c1c2a6290e91c0d5f1b5caf610	957.36	17931491.250232246214793279	3913465	75	0xb911a5084232bfa026f563ff0352ddccfe54a396558c39752a735e3140ac5e5e
1321	0x0000000000000000000000000000000000000000	0xc28e865d701a3573485a43d858c2db46fb156301	2393.4	17933884.650232246214793279	3913467	74	0x1c4532020266ada3f7e9625c5c42321070c5c9c7b84f68f9d9fafd4a39ffc61e
1322	0x0000000000000000000000000000000000000000	0x880a9d2779da185c2b4f9dd05dd702ed1c293ad2	483.4668	17934368.117032246214793279	3913467	75	0x102e943b6a0889018dc2bb51f32031f31e302a68b01502bb06690c5bded523b6
1323	0x0000000000000000000000000000000000000000	0xc31167ed8b1882e4ac34ec245967bb8541a09cd7	382.944	17934751.061032246214793279	3913467	76	0xe8f78755f4fd5ec3bc9ae14cca983184f4f8a753c28249740f2c5df298f953d4
1324	0x0000000000000000000000000000000000000000	0x3ff5174acf01ee9749c37ae168494fc01e75c323	4786.8	17939537.861032246214793279	3913468	3	0x991952bc0e8e382cbfe16093102e8d2645e5b4ba851c1428efebe42d1e389949
1325	0x0000000000000000000000000000000000000000	0x6091320655a6127dd64507de2789101c728caad2	957.36	17940495.221032246214793279	3913468	19	0x7790e7191efc73d20768541bf1f9f79ced9c9c88382780886b6a307cb869de2c
1326	0x0000000000000000000000000000000000000000	0xefd0f7142e514c67a4fdfc82f95aa5d149c9872d	4786.8	17945282.021032246214793279	3913468	23	0xa0979aa17374660c5db25df255dca9a3e0546d415c4442c1e11cc9393b93b6d6
1327	0x0000000000000000000000000000000000000000	0x6ef3f68e7356c61d6bd62fbc7295e9c821bee063	34.46496	17945316.485992246214793279	3913468	79	0xe6869e3d54a62c5e7b449a34833f3bc0b418ace044ab6861c38ce5beefe919da
1328	0x0000000000000000000000000000000000000000	0x27dd12a74b3c57ff67dc863cb39ee799091ebdb1	1436.04	17946752.525992246214793279	3913471	65	0x1b17d2c79faa2119aa1ea49fd54a8a323610ccc102ab241a2dadcee3fd5fc145
1329	0x0000000000000000000000000000000000000000	0x172d6497e054c79fc6963e388ab6715c9e3ef523	477.4833	17947230.009292246214793279	3913471	69	0x8572523b5f25d2d54e355fd72c235b8c316bc0f31de72e5756edf5ab31473d68
1330	0x0000000000000000000000000000000000000000	0x7e2acea8ebd261081809b3c78822ac21b4f18fe7	3350.76	17950580.769292246214793279	3913472	31	0x1eda6d1dd45aa76093df61f968f8fe46fef6269234ed228bbddaedcc35a03f64
1331	0x0000000000000000000000000000000000000000	0x431c75744e4514885712f80e92de945cc047d892	22258.62	17972839.389292246214793279	3913473	37	0xfeaa6dd7291d6dd9375f700bbb17fd2c712ed7840606c85ffb15c8218e93d1a7
1332	0x0000000000000000000000000000000000000000	0xdaa146bce939f82d1f6a4e7d3d12e8d698fe2b99	478.68	17973318.069292246214793279	3913473	101	0x1894a100a6323abbad41d60924a591aaa88b3645dd04280031cdba4f2c4cde57
1333	0x0000000000000000000000000000000000000000	0x0e9571770f5e81cb9b9a4ae3b8b7b56757a4bed9	1436.04	17974754.109292246214793279	3913473	106	0xf6ffcd9f617e16d231a6e0c97d16f6380613c02dbdf2fa62f5e3d744244695fc
1334	0x0000000000000000000000000000000000000000	0x04eceef9d67c39c3927068a3c2cf11ad1952f893	2393.4	17977147.509292246214793279	3913474	4	0x55237a0db8b810f0929bee63961f4906e157c5804c5e296697c61557d25c669c
1335	0x0000000000000000000000000000000000000000	0xff8536eddad144a0005cd6f34999a11a9a871ddf	957.36	17978104.869292246214793279	3913475	1	0x01dacc1863f842499e1ef8d29abb4f34f3c0d6da76586077351259907df41d53
1336	0x0000000000000000000000000000000000000000	0x8bec936f72b8d7756d11f13beafb7e973f74f3df	38.2944	17978143.163692246214793279	3913475	37	0x6899aafdd0559b20e4ea6c5bf166acd0c79e0bde500ad420e29ed03937317aba
1337	0x0000000000000000000000000000000000000000	0x339b48a764e04f1174990ecaeb0369daa1ed0ae3	5744.16	17983887.323692246214793279	3913477	5	0xaa255fe544a35ae3ab243368f17d25e1b39d22d2ba7ab9d7fa24fc94f7fccd48
1338	0x0000000000000000000000000000000000000000	0x564afe1f92383df3bbc1dbb608b0be91be03b04a	478.68	17984366.003692246214793279	3913478	46	0x5c840e56c55650148cdb867341164ac7ef0963f9b4df61f313b3733f90623bb9
1339	0x0000000000000000000000000000000000000000	0x17581b62da870a929d68af4b0d2422000aafda10	660.5784	17985026.582092246214793279	3913478	61	0x762e5b4bcda619edafeeb94085253bb232992c9d9888c2be6498735f66d339ec
1340	0x0000000000000000000000000000000000000000	0x723b4dd77184f86050ff823c4783a6e76540c0bf	14.3604	17985040.942492246214793279	3913480	15	0xe087b53adeb6e0eb4016cbaeb46f07f2aeea53e6c13a8c062360ed2c7bb53c86
1341	0x0000000000000000000000000000000000000000	0x1d9b54362d03d01dae17ef4289adc44a0ff3c831	904.7052	17985945.647692246214793279	3913480	16	0xbcde267e3245bceb4c41b4432fc8b6e4ca666de1b9a0658f41628a6d4de83613
1342	0x0000000000000000000000000000000000000000	0xe79f852fa4782b50abc4b41eef3588e1323eb262	181.8984	17986127.546092246214793279	3913483	33	0xed7422c4efc45f03a294d4834eb2bf2396a4fe7573efc78c0914fa17f6209658
1343	0x0000000000000000000000000000000000000000	0xf9135b2c152e8290272d8d612b6e19a1db7e68fd	229.28772	17986356.833812246214793279	3913484	66	0xcda7e31844849c5e7610a5f409498e3a5e6cac3f9be74d59fe670bbbc973a244
1344	0x0000000000000000000000000000000000000000	0x7d57b8b8a731cc1fc1e661842790e1864d5cf4e8	478.68	17986835.513812246214793279	3913484	68	0xa9cf0021d823a25dc377c2bb8e256bdeda0a0ee781c3f92ae28d74464faf1b94
1345	0x0000000000000000000000000000000000000000	0x68717b3ed53789dd6690f8a347ae65c5415b48d4	526.548	17987362.061812246214793279	3913484	83	0x6f9219ac56ce68b041eaee51af4a67783231ff4467df2dac3c8dd3ac4eb40194
1346	0x0000000000000000000000000000000000000000	0x0673e9b46da3509da066af87d5f2094b3f4f3126	478.68	17987840.741812246214793279	3913487	32	0x32ba5a2cfe7a4466c825cf2f4af3c7b21300311d1b6b98218ef50bb8d13b9686
1347	0x0000000000000000000000000000000000000000	0x6934f584bc6177bb171f2aa34ec4da5b53a3f0e1	23.934	17987864.675812246214793279	3913487	77	0x88eeed11ce4f1588ed8f458e43e9044a6bf35c133873ef386a2c6f70aa8cd869
1348	0x0000000000000000000000000000000000000000	0xd9ad97cca5fa0fb8f1f70dd0f45c02e76cedb9f4	23.934	17987888.609812246214793279	3913487	87	0xb812d6bd149785ba7fbc0c83f8e9f3adc3947f3e43ea4b3c4f0d0b94203a0145
1349	0x0000000000000000000000000000000000000000	0x86547b78ad328ad0662866656c91f5327c45745e	1428.8598	17989317.469612246214793279	3913487	101	0xebf461ec98319e5f4b4acc58881c5254607814067ac062680236312b5d827ea8
1350	0x0000000000000000000000000000000000000000	0x728259e6a43ab15ca950f43cd545a6130170fb61	957.36	17990274.829612246214793279	3913489	4	0x520d96588f7eef59236dc987b8ecee0bb5a4a45f8bf143bb6816e9620e7f4292
1351	0x0000000000000000000000000000000000000000	0xfa21161301eb5b99c6327dff352d4da27efc5709	77.06748	17990351.897092246214793279	3913489	47	0x502dc6a119266c6814064f56ed1ed26d6381ba0443f68fd68618119df6bcf6af
1352	0x0000000000000000000000000000000000000000	0xbb418c47bebff00d4a0bfffd6b066dffbefa474c	478.68	17990830.577092246214793279	3913489	66	0x1f3c6ae43783070d0f9dff7653ef25beb718ab62e906d78897fb2dea929b3af9
1353	0x0000000000000000000000000000000000000000	0x32ba9a7d0423e03a525fe2ebeb661d2085778bd8	23934	18014764.577092246214793279	3913490	25	0xcc709d79e2552e6d1038468c47b3ef931d0f21210e9100ed424537bd677729cc
1354	0x0000000000000000000000000000000000000000	0xc194cb83f97f0ce42d9982f4b5da721f40d259eb	478.68	18015243.257092246214793279	3913490	70	0xa074190f1fd6f2e16efacab991e70167fddaa929497e9f17bce230b9b7c5aee2
1355	0x0000000000000000000000000000000000000000	0x6101fd9ce17e95f1a5451e62aad8c6a92530d64a	2680.608	18017923.865092246214793279	3913490	78	0xe22d52d6590d86b56db50383e116ab0381b9923a33b9b6966e13003f8a0fd388
1356	0x0000000000000000000000000000000000000000	0xcd3bd5418908f223c067d61dbf08d6249ea9e448	239.34	18018163.205092246214793279	3913490	97	0xfbf0ebc2b3a829eabaf0ce7feb17c2e4ae0d2e2e4175ec80093a66222d05964b
1357	0x0000000000000000000000000000000000000000	0x30361261de45d98924c970122ec7d9a34cee8c1f	239.34	18018402.545092246214793279	3913490	99	0x6b3a94257fa533db9a8a363862e863eb242b0df79552a9d6ffbaf370bf0909a5
1358	0x0000000000000000000000000000000000000000	0x656cd70c303e24ff65d2c3f9c7b0fe7782f5c4e5	998.957292	18019401.502384246214793279	3913491	32	0x25976557daa3389c712af3314e1062c7fad2f04bcc6ccb61f17bacfff14b65c4
1359	0x0000000000000000000000000000000000000000	0xb80971fbd786b03e1947297ea184a3bf0b93a276	718.02	18020119.522384246214793279	3913491	33	0x2c3d5d305aae8d99ea87f8bdda90ecd93fd63b7005c4d749eface95c9267912d
1360	0x0000000000000000000000000000000000000000	0x090cc5c03bd172ae85e3b4f65726baaf956ec9d6	1436.04	18021555.562384246214793279	3913491	70	0xd4c46c470de099c228871299695a22b3176de9b92de1ab0c9ddfae176b860251
1361	0x0000000000000000000000000000000000000000	0xe66ef6fe93c04f60178b11744246fd2f497f583a	478.68	18022034.242384246214793279	3913493	88	0x7c0ae750510f8bd041d2ec51533b8cf3ddabb7e58509cf43e1fe6d42d3a0410a
1362	0x0000000000000000000000000000000000000000	0x738ba26e74d3e81a1d13b6d6c21b94c8e2911044	2393.4	18024427.642384246214793279	3913493	155	0x018a181bd844e3167dfa704da309cf4842d085109adcd59318496b6fb648b1d9
1363	0x0000000000000000000000000000000000000000	0xce4a0ccf8c1b79243684617a3508448298fe8f79	239.34	18024666.982384246214793279	3913497	0	0xf0a7c8eae966ea98757d7809233322bb24530ed3077214d8696f5138932af875
1364	0x0000000000000000000000000000000000000000	0x9d065d77095499cbde585a00cf4da07168a60ab2	167.538	18024834.520384246214793279	3913497	15	0xb5e5028db2bb116e14aa74ff5909a5024e2a07bc06b0f3b1f00f433238784bef
1365	0x0000000000000000000000000000000000000000	0x04068b7e74f348d96b2e8b350806cd40c503fb55	320.7156	18025155.235984246214793279	3913497	46	0x311c25f25f4353c72b7b9b9a1886bdde63295cf0f93a756bdbc4a98779977827
1366	0x0000000000000000000000000000000000000000	0xec9a9187bb799d51a8f6e0b69f0d61b08cd471b3	119.67	18025274.905984246214793279	3913499	20	0xc00be4b37cd63f65ab8a402b006b4f6c155110c313010bd802735c82dc3cf1c4
1367	0x0000000000000000000000000000000000000000	0x8ea1bb8aa59258bfd4688196cab3bbfb3c699345	957.36	18026232.265984246214793279	3913500	4	0xef27779ac4d7339560ba76938ae11d73706f8b7ee2ec85c14d00f1f93e97e1c2
1368	0x0000000000000000000000000000000000000000	0xeeb4ec99135cb3f3b448ef8bcff20208e943566f	23458.19208	18049690.458064246214793279	3913500	31	0x9d84a1a0b2f697525acfd5cce9993c71b5d9f40350e4dbc55862a86d2b2e1dbf
1369	0x0000000000000000000000000000000000000000	0x9eac7b2a3ab8b99a9a39b7f0f182409875d9c4d4	239.34	18049929.798064246214793279	3913500	63	0x9c5e5255e210595a02a44941ebb464db8f7934a5cd213c74af611dc03f4bb28a
1370	0x0000000000000000000000000000000000000000	0x307d5d07db2c59ebd345b8a73c291ec926d30120	957.36	18050887.158064246214793279	3913501	4	0x208fac192ddebcef4ba2393a01f5f2610095b76b2492c16f732b80d82bbcd38e
1371	0x0000000000000000000000000000000000000000	0x90ef7500c348a43d71b447d56f91f2a7bee27ce8	239.34	18051126.498064246214793279	3913501	9	0x0bf57e062e4dde3ddd8940fe1d648195eb06b56639fe71fa874bdac33cabd194
1372	0x0000000000000000000000000000000000000000	0xa45ef90899c284f8eb2eebffee8670221dc76a50	2561.89536	18053688.393424246214793279	3913502	49	0x56f7da8d934125d9a04fd49e9ed1dfe5e4714b27cab3787759303a7a29cad1f3
1373	0x0000000000000000000000000000000000000000	0x3cf553428964450b54a79439abf7447414364aa6	478.68	18054167.073424246214793279	3913502	53	0x71981605228b33a11f4a468256515b07084db1a743078f3a45f0a8e535dc7b86
1374	0x0000000000000000000000000000000000000000	0xa5659c0a37a63c2cbada7264ca08cd76ed06c347	239.34	18054406.413424246214793279	3913503	21	0xcd2daa526dfeda61ea4786b7bff81f5dbd6ad370eefd2aa22f4e4d370b3ead97
1375	0x0000000000000000000000000000000000000000	0x6091320655a6127dd64507de2789101c728caad2	33.5076	18054439.921024246214793279	3913503	35	0x0eb7898feb0c46537541f3e519bdaef1a196b4b7a16fa609bf10135a05c2651c
1376	0x0000000000000000000000000000000000000000	0x0bb50e918cca548b751f02541886e1a07c00d7e5	478.68	18054918.601024246214793279	3913504	2	0xe61bcb7d3ecf0817669fc45a74cb5a06aca8348f590498d7d5a5ddcb82dc2701
1377	0x0000000000000000000000000000000000000000	0x00964e7db1774bd8580006ef40ef676bcbe2ad2d	4786.8	18059705.401024246214793279	3913504	11	0x5325330602673ea4d153984962f76bdf1c3b6a88795b99ab5888519fce4a690a
1378	0x0000000000000000000000000000000000000000	0x5fa3ab44151ae8d6e582ce6ef4a56973f9d7c3f8	2393.4	18062098.801024246214793279	3913505	61	0x82e07cc8127d99639d84a1d71a3b0079218c8ffc6264c398cc332b8c8aa669dd
1379	0x0000000000000000000000000000000000000000	0x641cb232bb966402a7d6877ecc28aaf883f5b13f	957.36	18063056.161024246214793279	3913508	37	0x3335561313943c021ae4e4bfacc499347f9cabe19fb3eb8bca261813c63d006c
1380	0x0000000000000000000000000000000000000000	0x8a07a0402b522203cc8c8192cc11e546dad476e1	2393.4	18065449.561024246214793279	3913508	54	0x874b117e636cde514efd57ca909646ad77b709fd651ca5eda87c006dc9c1a2d8
1381	0x0000000000000000000000000000000000000000	0x1929041da5e141036a5f9b87814cbb61f324d036	191.472	18065641.033024246214793279	3913508	59	0xaee716012e539c1efd0e190f7ec53c286ffba5ae2b6435acbf6a4c16f4b6e9df
1382	0x0000000000000000000000000000000000000000	0x9fd66eaa211282e3b26d3bb9fd8ac7e89600c4b2	1436.04	18067077.073024246214793279	3913508	89	0x7c8d7b8ce46c315adeddd922de86b45bfbf56e10704a5a0bf008774cca5baa2a
1383	0x0000000000000000000000000000000000000000	0x7d41740d6772fd1871a9909a66ec71d4bf7fd51e	28.7208	18067105.793824246214793279	3913508	100	0x1a845f73b47bda7b3220a94e932c0b51106ed33b50d6249eb4c9c266949aa26a
1384	0x0000000000000000000000000000000000000000	0x0de8e811096d1a28d25e10ab5bcdf0df3427072f	220.1928	18067325.986624246214793279	3913508	107	0x9972dc1fb2626fd51e79f379e9afaa276f16be4a351708be23a217c339939af2
1385	0x0000000000000000000000000000000000000000	0x7f7fc02f284a3f1125b580775ff545575625160c	957.36	18068283.346624246214793279	3913508	108	0xbcbf81a828732615771d0809d25fd60a618aabf23eb7a443ac85e60c95009abe
1386	0x0000000000000000000000000000000000000000	0x0ce18139ad6474c538b2afb5135d6a60b21abeda	952.5732	18069235.919824246214793279	3913509	88	0x6f2668bc3881a62bd896d890d490bcd8deae9fd5232400fa69ad3f7fcfd68c93
1387	0x0000000000000000000000000000000000000000	0x8f6e7930cd50ddbdb1ffb019488b06a6accf19e5	2393.4	18071629.319824246214793279	3913509	114	0xf6948fc869b61e86d7f0064a7cc395cd6e185101be3743480bab89b7d6d5aef8
1388	0x0000000000000000000000000000000000000000	0xc97d0129d9f4ca738aaa4ceec22247abfb97526b	183.81312	18071813.132944246214793279	3913509	128	0x1ee79749749b67766dbc9be93d2a90e12ca7ade0a1976cdef9667752105f5440
1389	0x0000000000000000000000000000000000000000	0x44382eaa886d7cc9c2c228751fd56b41762c1bc0	239.34	18072052.472944246214793279	3913510	3	0xf439c79d11b0ca2004faf4d6aa2c52bb158e8524e0bbf7689c261560bf230f0b
1390	0x0000000000000000000000000000000000000000	0x8f7e5f5cf3db6d87ad9770884d4ccc5d0d63440c	430.812	18072483.284944246214793279	3913510	14	0x6c3032becc6cac9d58d5c28da019f9bb92e43d56554aa9f9c83e8e85e5f9a33f
1391	0x0000000000000000000000000000000000000000	0x355bc9d8cc2cde13c5073276d145d0e3d210b2c0	1914.72	18074398.004944246214793279	3913511	0	0x37dcab3f93b7052bf86e73ab45c7a559baa6e9a4aa57023ae77c005cd676f82d
1392	0x0000000000000000000000000000000000000000	0xc01b854525a8b76ba220126c1e4bc924e7b3e734	3350.76	18077748.764944246214793279	3913511	17	0x8c3e85f8022e557f8e13fa85961174a0dc7eed82e28362cf979e3847798943a8
1393	0x0000000000000000000000000000000000000000	0x355bc9d8cc2cde13c5073276d145d0e3d210b2c0	1914.72	18079663.484944246214793279	3913516	1	0xa27a3bda35edc489638e8b5270ac8828556509f7f38fc485073399825b3a703c
1394	0x0000000000000000000000000000000000000000	0x880555d744d7a92ae25791373bc472c1454a98cc	861.624	18080525.108944246214793279	3913516	35	0x88941d34473303e70cd60fadc0dd7903add1f093c59fe034c0adb29ed0ca3d9b
1395	0x0000000000000000000000000000000000000000	0xf766d2eaf5392b862d80e5d4dc7786b7f5ed1a99	239.34	18080764.448944246214793279	3913516	41	0x4a2e9f9f9006d371dc336279d54a2b06f6529bf210cb95a7dfd8dbd665ad0435
1396	0x0000000000000000000000000000000000000000	0x00986f60def75c9eb80f7a6428d5e334518322f6	1436.04	18082200.488944246214793279	3913518	29	0x262b4e3f9c43b8117a27cf318b75a1e7615eacc68b8eefe0f6c5bb28f6f30eb6
1397	0x0000000000000000000000000000000000000000	0x0d9cbeb06d4e6fa0c466507d8727da2065b2c23c	239.34	18082439.828944246214793279	3913520	13	0x09d44851d6f663c0814e3868363c93717b7032198e00e34b1cda4ec5a97c4d00
1398	0x0000000000000000000000000000000000000000	0x70cd246ddd15261d6b579f197b30d4ef7bd5fd95	751.5276	18083191.356544246214793279	3913520	34	0x04f8bd7ad6bc64fefc914bd021baec6b5de455b6f04c7ee1b98fb6c89e067ce9
1399	0x0000000000000000000000000000000000000000	0x7bd2f36b73fc3a09cdcd04c7aa7160b5b14c04fa	27.268197672	18083218.624741918214793279	3913522	2	0x060876bb880e5ecd6a8a527f6436baade7ce40b65399c4159dc59fe5d899cba4
1400	0x0000000000000000000000000000000000000000	0x7e2acea8ebd261081809b3c78822ac21b4f18fe7	478.68	18083697.304741918214793279	3913523	59	0x4e1a694d80f429e21a5ee42df3e081e35d6a38d600c74d12f033d0b15ca65836
1401	0x0000000000000000000000000000000000000000	0x825b9bb81e270c69a891a35bbc3770396beec105	239.34	18083936.644741918214793279	3913523	85	0x931862954067b41e77a7d7befe9db3981ab84d58c109f7ad91a7274c390e3f34
1402	0x0000000000000000000000000000000000000000	0xb253342821c1c9c6e0dccc4a8d28c372403a4726	143.604	18084080.248741918214793279	3913524	19	0xd0fb5e4029cd23b5dc95729bcf06fc66bda152065583bd45d5498f8443557f32
1403	0x0000000000000000000000000000000000000000	0xa680233c045af14e01090ecc56b922968d833883	3829.44	18087909.688741918214793279	3913525	9	0x008f42a133db3c8cbcd34e9fd608cbe73ef374a949f623caa477f9f855706cc1
1404	0x0000000000000000000000000000000000000000	0x2b2d8dfd5ecec8a1714ad15cb24f22ef1677ed6f	1196.7	18089106.388741918214793279	3913525	36	0x5d57b9218f98134ef62aaa40a1259f06d346605317ebde3ee53db36c63cb4987
1405	0x0000000000000000000000000000000000000000	0xe5d66c210033bcf7abddd79ace5e72131882d76d	478.68	18089585.068741918214793279	3913525	61	0xfaba551f7b780b6b13e91ed8277a059598e9c75773a6e050cf602764e7eda260
1406	0x0000000000000000000000000000000000000000	0xd0caad3c848ba6f68e32930f44e255f498afee48	143.604	18089728.672741918214793279	3913525	93	0x8b989dbef6be2e97f4ec49bf0c45393dc7fd313b0b9b936028c96f6b02828d2f
1407	0x0000000000000000000000000000000000000000	0x000cdbd6271d0a2c953a9539905289e95583b7a5	957.36	18090686.032741918214793279	3913526	56	0xb726e4fd3e2d9cc75aac1e83539f64ac12fa7adc94c5354fd0c00d3a343d5f5b
1408	0x0000000000000000000000000000000000000000	0x130095864efaad9f4a2dcb67903501edafaa8b1c	478.68	18091164.712741918214793279	3913527	29	0x44fece7c3fc1d7fb97e0cc5680460f513f0957ec6f94be61ef5f524b9d785c85
1409	0x0000000000000000000000000000000000000000	0x026314fdb18bbc5c86e2fe59819d9a510f163ba8	478.68	18091643.392741918214793279	3913527	31	0x0b4ad7a9edef57baaa958d557b50f0c510757d7a5ccc5c0dd4c3087ffaaeeb8e
1410	0x0000000000000000000000000000000000000000	0x08bf7d718251930fd52819a97cd44ab1e4f44cff	957.36	18092600.752741918214793279	3913527	38	0x4b7dbb1896cf6486875523a68fc19fb4b930a682c3b34e0ed8772ce7d5463cd6
1411	0x0000000000000000000000000000000000000000	0x75b09622cb94b919e8887286d9c89c84988f1f93	430.812	18093031.564741918214793279	3913529	16	0x73bfc958071b21e2dedd96889116e0fbf1a74927fe27afc19ea758919527c61e
1412	0x0000000000000000000000000000000000000000	0x03fe00d55a4af6510fc2de741574a86608d1117e	7.222850388	18093038.787592306214793279	3913529	24	0x2a2a6fbffb42d36422e84bd1109de5d8d24d44620d0409555b84b01ea4be452d
1413	0x0000000000000000000000000000000000000000	0x3e8d412c0abff2edca2a987149aa6aec7288912a	239.34	18093278.127592306214793279	3913530	2	0x28abee4708317a0f3b17cef5d4c4ce278ac4ed14ed94a6203264796bd35d373d
1414	0x0000000000000000000000000000000000000000	0x4d42f2598fdb3f15a22ed80b0d9014d235cd687f	957.36	18094235.487592306214793279	3913530	3	0xc86ff5e1aa946de8515e6a735611a38660d32daf46a72843968d45a78bacebe7
1415	0x0000000000000000000000000000000000000000	0x307d5d07db2c59ebd345b8a73c291ec926d30120	1436.04	18095671.527592306214793279	3913530	4	0x7d2f2bab398d452d5d48d21795504af3596876d98ee710a53109025fec6862ce
1416	0x0000000000000000000000000000000000000000	0x09462115b82c38bf9a5038dbab1a200594e0895f	8616.24	18104287.767592306214793279	3913530	23	0x9dbe302f4013fe2f2777cdf1c3ad9d5e5d18c8147841878bb566f16f2be21906
1417	0x0000000000000000000000000000000000000000	0xc057d5dda8f212a7f8b47ae7a5fd6707d399aaf2	951.038097174	18105238.805689480214793279	3913534	54	0xdb3b51e7d3dbfc3701f6d2276db5bb62f832ea00387a6a985e61f31b694d40a7
1418	0x0000000000000000000000000000000000000000	0x278e0ec12017836b7d9bee5d57bcb8a1e79bf644	3350.76	18108589.565689480214793279	3913534	63	0x67940210a6b530e5e8c95322c21ae6f1dfec70629c4e2056d63f0c2700bc3750
1419	0x0000000000000000000000000000000000000000	0x37f6839bbf16e5dd7526094e6f4360e1e9006cdc	47.868	18108637.433689480214793279	3913537	35	0xd231062180b367e74cd72206424bb44e2e8e34be718b3f5acb963a0cf66fb5a2
1420	0x0000000000000000000000000000000000000000	0x17581b62da870a929d68af4b0d2422000aafda10	572.50128	18109209.934969480214793279	3913537	49	0xf114aac597d5ceb1a3125f7d6fba7d704fe70ae2333a054955d5c6897d93f174
1421	0x0000000000000000000000000000000000000000	0x08ae99b68bd073214b87261cdca014b3cb479e67	502.614	18109712.548969480214793279	3913539	33	0xbf71decc86128875ef565d977f94f3a9d084d3290383e365d442ef9fee13fb4d
1422	0x0000000000000000000000000000000000000000	0x026314fdb18bbc5c86e2fe59819d9a510f163ba8	1043.5224	18110756.071369480214793279	3913539	40	0x5d6c3d8cefe7f41cdf2fcaea8f827f47b7106491dd5a5fa1b90356f863357fe4
1423	0x0000000000000000000000000000000000000000	0xbce1b0420e44245e5924f6d62c8c797003ec3622	95.736	18110851.807369480214793279	3913539	42	0x0b42edc79f81d351447dda2f002715496663a307e7cd707bdf671d1d62d83293
1424	0x0000000000000000000000000000000000000000	0x248c224fc1cbf60ac2b68162d028cc1cf9168de4	119.67	18110971.477369480214793279	3913539	49	0xf8691cde2230df567c9e58dd558faf24389d00be39fdc6a8861c75aa3eeceaca
1425	0x0000000000000000000000000000000000000000	0xf033e90fa312fd7e40f1a0d67a42f18fc5d97c79	1914.72	18112886.197369480214793279	3913539	56	0xbdc6545ab4319724867dd3d3d6a30a14a1a1a94ce3e7ab56df9ab1cbdbbcc9ae
1426	0x0000000000000000000000000000000000000000	0xa83fb5e6a8706c0e495e683c6b70c15a98a1e32f	47.868	18112934.065369480214793279	3913539	58	0xfdc6174a17c87a0e19bddd1bd94f260c4257a01fa7d8fd32e6a3532db2bac3cb
1427	0x0000000000000000000000000000000000000000	0xaa9fdbd1c668ecbb8f99e9b6b8fabed1c333ccc8	191.472	18113125.537369480214793279	3913539	59	0xf20a96f73c4e7441ab9547bb43d77c8336ed8972eeeb6a7a750ecdc4fc7e7dbc
1428	0x0000000000000000000000000000000000000000	0x42a024d4f95689b5efeeefda21043a74670f93b5	478.68	18113604.217369480214793279	3913542	31	0x45eec3387664ce1f480c9c028e8fb5fcbab64db5e229763ca457068411de19f3
1429	0x0000000000000000000000000000000000000000	0xdfba7c3641f1852c62da05e61ad3bd10fd66db55	4786.8	18118391.017369480214793279	3913544	23	0x57d9adfc616293420b7553a7a7b4b55d6a4b51b2904b1571615220d251e955ac
1430	0x0000000000000000000000000000000000000000	0x94aeca1c849e99b373a7ba800c02c3036c5e4976	472.45716	18118863.474529480214793279	3913544	66	0x7e03e1bdbe1f10f7b338fec43702e915eddb590aaec5e95b56ebefce4c93618e
1431	0x0000000000000000000000000000000000000000	0xdd53dc054864f5554986d6cde6c05756d5cf5293	1436.04	18120299.514529480214793279	3913545	21	0xcaa8ff1975a6fde25e634b2677d1b8c00c470f4a31a0dd3fbccbdbda2a0a8a6a
1432	0x0000000000000000000000000000000000000000	0x0ce18139ad6474c538b2afb5135d6a60b21abeda	957.36	18121256.874529480214793279	3913548	13	0x87ba62ee88f627c0d0133d4c43930374fd58cbec97888566e8c59a811508cddc
1433	0x0000000000000000000000000000000000000000	0xacdc9bbb04cf7f3a1da12473136ac4e721e36569	957.36	18122214.234529480214793279	3913548	56	0x936fc1d2cc434be7123f226ecc41ca11226b5c8ee426bc7b6eb81f2b8e412a35
1434	0x0000000000000000000000000000000000000000	0x603e64052a6cc8dd448eccc33c1e4037e75b7d32	3532.6584	18125746.892929480214793279	3913549	18	0xde678fc1a7d3e8d8c28182bf67839c799610427d1b069f3f416959e30576c8a1
1435	0x0000000000000000000000000000000000000000	0xb1bb8924202b4932203a2de4733a95acba81a5f6	477.72264	18126224.615569480214793279	3913549	72	0x374a83734966215709a178586d5f97c32b8f16893d733ad73768896953d3a135
1436	0x0000000000000000000000000000000000000000	0xba079b44c7079615cb7e56b1e4e0fd566db419df	4786.8	18131011.415569480214793279	3913550	31	0xaaea62367bfff51854f171cdaead8c93e81a7e677698fddbc3fb24020853cacc
1437	0x0000000000000000000000000000000000000000	0x7cf1e9ee4017004a3607958b924eea86763c56b9	2393.4	18133404.815569480214793279	3913551	60	0x2fb2b83c819b0e6e160d75b48aff081ceeca0978362792586b2b7de6c733bf47
1438	0x0000000000000000000000000000000000000000	0x5c27735cdb5831f181fa1f1a94b65be1e3629164	143.604	18133548.419569480214793279	3913551	82	0x3581e2f6cf20c254cf42273d99aef69946804deed24e11dc8755e8bcfaa487cf
1439	0x0000000000000000000000000000000000000000	0x95c891f82bed97e307e333820b899e02a992ce99	1436.04	18134984.459569480214793279	3913553	12	0x0a17d891cc72be7d7b72124cf7a922aaf4bb67a6a12c430dec894380a52ff619
1440	0x0000000000000000000000000000000000000000	0x62fb600ffb5b3d2f50caa138e5bcc49b824ff398	478.68	18135463.139569480214793279	3913553	31	0x1f06ff30f3c5d35c77f6b185205eacf4cbd053ecd73c57988037dd98f37a7ada
1441	0x0000000000000000000000000000000000000000	0x64d7b2e252e12dea6b42aea317f8f2a5adc559ca	1546.1364	18137009.275969480214793279	3913554	1	0x13ff5361ab41a0a46246bfd1cce0e5d008adf31617e3822490d2d83a9b2f9fd6
1442	0x0000000000000000000000000000000000000000	0x4d454f48989a2397b680568139e1aed25c0f649e	382.944	18137392.219969480214793279	3913554	20	0x4685e3f4a75a102a0311a32f9bccf8b79529e7abdbed52f1fc634201fe2a391f
1443	0x0000000000000000000000000000000000000000	0xdd53dc054864f5554986d6cde6c05756d5cf5293	2872.08	18140264.299969480214793279	3913554	33	0x884fae6be01fa01acf0b36c1fa78095d1e1237662e89e55ed4d0c8a18511e874
1444	0x0000000000000000000000000000000000000000	0x1d758dec1a1c752f0942e4044f1c6a89742c7ead	957.36	18141221.659969480214793279	3913554	58	0x26ddea70c15e33e7bdc5d1e4344dfc5efb96fc7f5f26f2d1696b0f3b163cf883
1445	0x0000000000000000000000000000000000000000	0xc001da90d5a8acb971cf9120e48d8c80243a4ce3	461.52221705664	18141683.182186536854793279	3913554	65	0x87e4432fe4e8c39cc46160ed6c9bba3393a083b7f2433a8154af81ce9a31b6df
1446	0x0000000000000000000000000000000000000000	0x8622f34404b22fc65024bd459c1d4ffaf59911c5	143.604	18141826.786186536854793279	3913554	91	0x87c088444ffaffa555f7f7bb3d853f0d3066484c119a36e399d92edea645ad39
1447	0x0000000000000000000000000000000000000000	0x2b1d032fc1e85d4b81610e805748dc0f95d23b74	3535.0518	18145361.837986536854793279	3913556	8	0xeeec7209fa5ac703a62dbaab68445bf7a12d0e15102bb5578f003129507d6a5c
1448	0x0000000000000000000000000000000000000000	0xc89ccf4ed99195125cf5c8789be0ef7b8090e853	957.36	18146319.197986536854793279	3913556	46	0x1a4e0cfa99bb4fc85d424354cfde5c72f7e1d625f1b106738904d2e93948cfd2
1449	0x0000000000000000000000000000000000000000	0xa9ee7a7f0c908b7f5fd947e0da8f392ae03a1018	10530.96	18156850.157986536854793279	3913556	85	0x81f39608a92586409e9ea2968527be991de3dbdef677c049f61004237aacb834
1450	0x0000000000000000000000000000000000000000	0xf8d38bf508aa5eec845b357fae52def265291361	71.802	18156921.959986536854793279	3913556	127	0xf7a7c524be5eae178aa7d8ebc1ffcd97bcd88fffe71d3f2c82a1566408b4b121
1451	0x0000000000000000000000000000000000000000	0xc7a44f7b1277ea76e12a1ded25d2b9bb7093bdb2	513.62364	18157435.583626536854793279	3913557	31	0x41a4e6c62a6ae7ffd0d3cfd5addb6f4f730e144a91db9798010d613c6529d598
1452	0x0000000000000000000000000000000000000000	0xb8c1f54384f3b27deb071fd0af5a5251c217d67f	239.34	18157674.923626536854793279	3913557	32	0x0b31e21e9b993d8101925962ac3ca569a03652c8011fcdfd518e723f67ef5738
1453	0x0000000000000000000000000000000000000000	0x29a4dd7ee378e0a6d9d27e3393c740760e7e2059	153.1776	18157828.101226536854793279	3913559	72	0x85f7a54b1461c9e4d7e10e120ac9da10edb6e8b7b5e76562c6854b93204f3719
1454	0x0000000000000000000000000000000000000000	0xd7a3bf435c1afe4dc25f4b4681dea2bffdbd0dab	2201.928	18160030.029226536854793279	3913559	89	0xc7bbb2769dbe468169520827db0e7b910c32cf7909a1a2f78c9e588229e67563
1455	0x0000000000000000000000000000000000000000	0x7004289a6ae25bd7dd09624d89762c4a371cdac9	2393.4	18162423.429226536854793279	3913564	6	0x79d91cd35052fa430b2a501c18b74f7f6d25c15e9cdded5d5bf560980b7db9a8
1456	0x0000000000000000000000000000000000000000	0xd6b356019c1ca6dd328903053b90b4b86387d969	454.746	18162878.175226536854793279	3913564	10	0xb628ae33a41b518e7f363c8244cfc6c4740792a7e7852bed983e0cc89a2f08f4
1457	0x0000000000000000000000000000000000000000	0x01f5be9fcc63bb4ede40e89db317d507c5adf81b	2393.4	18165271.575226536854793279	3913564	31	0x17946053439c7280726baa920010f4eda9da5bad99d15d3352f5f3c4eb7c6790
1458	0x0000000000000000000000000000000000000000	0xe6baf28d08db5cd542977a48f4d2349d42a2ec4d	957.36	18166228.935226536854793279	3913566	24	0xc48c1f4972f20dd61288d2532cd51ae2051dbd8cda99796c82ab357153f6966f
1459	0x0000000000000000000000000000000000000000	0xa76011fde264beaa80294796c59bafdfb7e0f493	2393.4	18168622.335226536854793279	3913566	59	0x92018163bcc4cfe4cf5df782acd05daea5393d2c889dc9c076ca7f3dbe9c31db
1460	0x0000000000000000000000000000000000000000	0x3076766df1bda07f4e117c6e007ab18a1b6ef929	301.5684	18168923.903626536854793279	3913566	67	0xc185a2e92dd79186dd5bc00ad26e0a3103a57972afe416d5f6ac3e9a7ec10b51
1461	0x0000000000000000000000000000000000000000	0xb7bfb979281653e88fb409461d39f319ae988197	478.68	18169402.583626536854793279	3913566	72	0xfce56612ad58e1d3d872860a9b684982d0825293b41cfc810ad46a46eb2bf4af
1462	0x0000000000000000000000000000000000000000	0xdd53dc054864f5554986d6cde6c05756d5cf5293	2872.08	18172274.663626536854793279	3913567	1	0x158eae41577c5cce8263e26a524f43c19e39457852a4fb47eb1443a0e508ef44
1463	0x0000000000000000000000000000000000000000	0xef462ae26b9b010c5860c38639c78a857af6a76a	478.68	18172753.343626536854793279	3913567	38	0x76b745fdfeda3a6746a095a11c4ee6b1dcf8ce59d9740123b64b1016aa1ecfe9
1464	0x0000000000000000000000000000000000000000	0x67359e66322044c0f8dee1cfa03c6e12f344271a	1093.609291690181762157	18173846.952918227036555436	3913567	44	0x26077fecb7ff92479f466b7f83f95af5b390124a43191dd37cac7fe694651059
1465	0x0000000000000000000000000000000000000000	0xc3afc7060e375745403029241bce57a220c0ccba	2852.9328	18176699.885718227036555436	3913567	78	0x68ebde5b59bb431cf3023db88d7c924b4a80cafd245755a039567e11808a717a
1466	0x0000000000000000000000000000000000000000	0xc53bb8f18844ee1ab1b5234b7de47a54a991cd28	43.0812	18176742.966918227036555436	3913567	79	0x6dd025139b7e493c276dd5dd0b059e67a77917e26be4bd3981225e5515fb1394
1467	0x0000000000000000000000000000000000000000	0x605b3d5076228be9511a626b9a08668de45b44a7	4035.1177791798	18180778.084697406836555436	3913567	86	0x240d07d70edcc748135b10d2eaba349009c56d76a59b076a6d7904f818d91fdb
1468	0x0000000000000000000000000000000000000000	0xad5fb27ae1b1235d001e0e910f7a1b5eef21f3e7	239.34	18181017.424697406836555436	3913568	58	0x91e7bd71924fe7e63f444880c031b459d8397fd32648b48668399282f0601a4c
1469	0x0000000000000000000000000000000000000000	0x906692908239030f5f1d348c03b6fc6081843f47	5744.16	18186761.584697406836555436	3913569	17	0x12f3b246ea379bfbaf21a11f8d7938ae9277436757cd90717825799e6a69fe68
1470	0x0000000000000000000000000000000000000000	0x68665558a5c0d302b20bd8142dcdf3a59947c34b	732.3804	18187493.965097406836555436	3913569	19	0x67aea65462a6e33e96cb67a75f346d7f3bd632eaaea5ed4caf5c1e7293cc8c86
1471	0x0000000000000000000000000000000000000000	0xba7024724b7f6b1b8da37a0d8fac3c399e9075e7	478.68	18187972.645097406836555436	3913569	25	0xc909fb3363dc7868bd1bc3fff322b7ad3ad0620fb33fc67750badd81241d550d
1472	0x0000000000000000000000000000000000000000	0xd5912b627b2704ca3604581100edc097d585f1a6	268.0608	18188240.705897406836555436	3913573	36	0x1f5b60fd32182f965f9a832cd2ae5e4616faa926ab90b704981cb4bbd7fa7d9c
1473	0x0000000000000000000000000000000000000000	0x21089c21574d1989900fc1d30e126adbf525a194	54.56952	18188295.275417406836555436	3913573	40	0x390e4d2d6feda47848ae01c615a3e38cfcd245f614915ee9575b5f4be552591f
1474	0x0000000000000000000000000000000000000000	0x2f2e52421adb652d9f40fe4a740ad0aa920bdd03	502.614	18188797.889417406836555436	3913574	14	0x852a5cb433ca0b678325630aba3256138a04865cd8e3b43eb0ec8a96cdf3d5ec
1475	0x0000000000000000000000000000000000000000	0x3e8d412c0abff2edca2a987149aa6aec7288912a	239.34	18189037.229417406836555436	3913575	6	0x492d465df743707faf8f54cadddd417aa5097db23bdaf2daaf2b03bda796b73f
1476	0x0000000000000000000000000000000000000000	0x26f108153ce2e59e606bc9a7eec37405d13d7fc9	478.68	18189515.909417406836555436	3913575	32	0xaa905a33867c719b931bfa9f221bcfa123f4bf362d516db57686436fe8afda9f
1477	0x0000000000000000000000000000000000000000	0xbd74bfbc361b6e9ad1b26e1ab62f1fd38c62ec98	478.68	18189994.589417406836555436	3913575	85	0x0fb744c94de2d3fc2ed0d1e3693a1f0f98e0b97f0958a337c0c277b77a92cf5b
1478	0x0000000000000000000000000000000000000000	0xbd84b61c9cfcf794973d0203de7891b37c838834	1436.04	18191430.629417406836555436	3913577	7	0x0323a53dd81edd5d4567466e8c86fd1a7ac2968fcaf5655835a8b3cf58f767d9
1479	0x0000000000000000000000000000000000000000	0x8e240e58e2ddf4ba3c556316536819c2527e171e	488.2536	18191918.883017406836555436	3913577	11	0x1a454bb81be27add41e1da7f42a96b7cbb10351b4b7dc422018759f233924365
1480	0x0000000000000000000000000000000000000000	0xff8f08239af5dd797f8cfc20013f560679c63668	239.34	18192158.223017406836555436	3913577	13	0x8ebedbe09ef44214e961bf4354f58d1932279c12470057b0128414b13e55e7d6
1481	0x0000000000000000000000000000000000000000	0x28d8c00ccff8dc2ef3e18614820e192a812f69f1	15317.76	18207475.983017406836555436	3913577	15	0x9ec6baa161c221f039001786f69ebde364913ca175a0f748aa3e7b447e95d190
1482	0x0000000000000000000000000000000000000000	0x7a3cfc1d40bde8b70de02bf315eadd96bd152090	157.9644	18207633.947417406836555436	3913580	2	0x1b5e6263415da388382a5a27b1a4d7c6a6cf8e8e71c11ce6e582e6c89b373c5c
1483	0x0000000000000000000000000000000000000000	0xc014f17aa7fc1de8633e45474e85e18e13cceb4b	478.68	18208112.627417406836555436	3913580	27	0x16e2f84486ac0012ca78176eb86105c417525859c10614798a0d826ad76c61e7
1484	0x0000000000000000000000000000000000000000	0x04bcbd0a1f9b00d87e3205ee7f11e80e005ad448	1196.7	18209309.327417406836555436	3913581	4	0x3b8103840d8412adfaac7bd47559a90cd90aa7809c5a74a97c8d14b3d0357a37
1485	0x0000000000000000000000000000000000000000	0xe3e1f7e7255cdf6892e8ad913c60b7a14328dc90	1914.72	18211224.047417406836555436	3913581	7	0xa0c070dda0fc80dd149d2b60da2ec0aec6ce64e6240988ad7e2f193c7154d076
1486	0x0000000000000000000000000000000000000000	0xdb9bb2ececf4cb64cba3943230fdf5871ae31330	478.68	18211702.727417406836555436	3913581	9	0xd4bc544e50c5fc1147baf75a374a4d5e384a041adb6bd186c0aba674c1365f1a
1487	0x0000000000000000000000000000000000000000	0x02ba277d2f3c935e9fdfb26263a06f799133f0b5	574.416	18212277.143417406836555436	3913581	32	0xdc25e319c8107d885e3742260f1e3b91afa931e6a4832b9f2a837b463caeb7a0
1488	0x0000000000000000000000000000000000000000	0xd08d42f8b1ea7a7ce994dab57e4534dff39962b2	1340.304	18213617.447417406836555436	3913581	36	0x104f5f55d127ed1d477e9b28a1e31820a39574d3e8725641e86fbfd7d8e4751e
1489	0x0000000000000000000000000000000000000000	0xe00488d3e0f4fba11c9d4311abd728233a3f52e5	459.5328	18214076.980217406836555436	3913583	0	0x27aab9310917ccedd63275c75f6bfed02c18f2a5be180af017962e1403f61973
1490	0x0000000000000000000000000000000000000000	0x00498b59e17128591131f7d3463195511ffa9639	478.68	18214555.660217406836555436	3913583	8	0xce737f3b65ccf5b35473268c366d7e476692812bbef339721c963ef02841d7d6
1491	0x0000000000000000000000000000000000000000	0xcd4d89e89e19615c8692f6969b1c2a682954d75d	3350.76	18217906.420217406836555436	3913583	49	0xe19ac830d53117177f68616f8efcb03deae350242c8b1e4f044f0d92314ff948
1492	0x0000000000000000000000000000000000000000	0xda78ccc8db749a6ef2bae0d806b29d9352e6ba83	1675.38	18219581.800217406836555436	3913588	0	0x422037ef4645b9886fdca7bc17a696b61578df3b58fffbd31bf84d059843ea1f
1493	0x0000000000000000000000000000000000000000	0x63e5e5276597f3c6aa057737d5cdbdcb25373ad4	9573.6	18229155.400217406836555436	3913588	17	0xee17b215ae9bb9ac887cd29527d08b3bcdba7849b2a48aa37a48c23d36f4fc81
1494	0x0000000000000000000000000000000000000000	0x6bf5fedc67ae13a2278db308b3c42e34300aaeef	239.34	18229394.740217406836555436	3913588	27	0xa8f279187e8dd8b1305dfe3f3d0e857147b72e5800ba2e33cc708f52f05f8c52
1495	0x0000000000000000000000000000000000000000	0xdb48c7b32fa3f2088e1598d90d0229d9b7f3ed49	478.68	18229873.420217406836555436	3913588	52	0x58341a8e77f0ceacfebb645153c2d1d2f0305b04282e90414bc8a5651c5f71d0
1496	0x0000000000000000000000000000000000000000	0xa75de5ad8c567a5cf513726e773af1f87ad3bfc1	1.91472	18229875.334937406836555436	3913589	5	0x8e4f29a53ab97a3b468be1e340ec030f81d1db33217721b8c312a7093c67aa7f
1497	0x0000000000000000000000000000000000000000	0x25ceac4b0fd802c4b9df7dd7c730d6c25903b11c	478.68	18230354.014937406836555436	3913589	19	0x0d252a62494da2fda25d20941e0d41017dc3d1d5f5f184263eaef4c8620a434f
1498	0x0000000000000000000000000000000000000000	0x138be8ec20fe15977113a14360a6017cf3836cbe	357.302462767596111997	18230711.317400174432667433	3913589	64	0xffa216fee0c768dc3c6e1f8a4aab5149a99289be2f62f07872e485c8a91fbb95
1499	0x0000000000000000000000000000000000000000	0xaa9fdbd1c668ecbb8f99e9b6b8fabed1c333ccc8	40.6878	18230752.005200174432667433	3913589	68	0x9c159139922dd928e0a7bf26f1bdd20a9211d49afc64b5151ad57e0eaf9d2eb5
1500	0x0000000000000000000000000000000000000000	0x26e00d40f4b48dd31f88b2e94bfae9cc90ac9523	2393.4	18233145.405200174432667433	3913593	27	0x16e94804dc2396249f62434573b4c6d405c5ca453b7a28c31867150e90cbc58e
1501	0x0000000000000000000000000000000000000000	0x641cb232bb966402a7d6877ecc28aaf883f5b13f	526.548	18233671.953200174432667433	3913594	7	0x73114eb0763e3566b614f2d7fbd8fc5242d800378a5a68c16b08080a75dae073
1502	0x0000000000000000000000000000000000000000	0x130095864efaad9f4a2dcb67903501edafaa8b1c	191.472	18233863.425200174432667433	3913594	32	0x16e5488edcc7dcc8f6636bb62802db1a4a7824d41e7b1f245c54daf554e6e7ed
1503	0x0000000000000000000000000000000000000000	0x34ac34a71c8e148ab6544b429ae0c62977731feb	239.34	18234102.765200174432667433	3913596	38	0xab84ea7dca22c34d179ff4608069145a63249710b744ff0dff331b96ef09fc2c
1504	0x0000000000000000000000000000000000000000	0xef15288173a751cad574132dbba558db30e14fca	95.736	18234198.501200174432667433	3913599	16	0xe315812acb572783e67b2027f893004fd8f596f98853ecc98d34739bf4543ed7
1505	0x0000000000000000000000000000000000000000	0xf1b8326e7dc39fb9aa74a973b48a22400830d6c0	478.68	18234677.181200174432667433	3913601	3	0x93f56473f024f1ba82bb7f390f98c8192a5c4431c7020db20709f4915335c407
1506	0x0000000000000000000000000000000000000000	0xb1a0d6d97383c069f22ecfc105d47f6aad250bb2	526.548	18235203.729200174432667433	3913601	25	0xcb4dfcc008092b77f0e9aa6837151d2b734a512cdbf5cc785c8569a0e0a365c9
1507	0x0000000000000000000000000000000000000000	0x223270e56c3e5cbd381906046e5061131c832daf	47868	18283071.729200174432667433	3913601	53	0xccae1c7793fee1c10a11267feee501e94dce01c69ac2194d5a2b3492953141e8
1508	0x0000000000000000000000000000000000000000	0x714359978ffcf74b9769712db729e8583e0f36c2	191.472	18283263.201200174432667433	3913601	57	0xf9b820310c6a628fc92db3fd053b616502a3db05cd5f32f35c53382cce6ac44b
1509	0x0000000000000000000000000000000000000000	0x21ec99e41a61db5e4b600ab16ad11a58dd49da24	406.878	18283670.079200174432667433	3913605	12	0x6ba9f00bf25d7de7c8d790f8617b92ba65b99c6dfe09c91f57810ccafeda5cf1
1510	0x0000000000000000000000000000000000000000	0x3d866c0051673d290ba1a9155ad30b28538ac75a	957.36	18284627.439200174432667433	3913605	39	0x41417992149fbb82240f01e34118d274fe429786352d8f9790337e0636c6510a
1511	0x0000000000000000000000000000000000000000	0xef9d331bda13836e8165138da70501ab3106076e	1436.04	18286063.479200174432667433	3913605	45	0xc16bc3b1ace0316267eee55532ffbed93c1d325cd0014e1e9bdaad0c830b782a
1512	0x0000000000000000000000000000000000000000	0xa4f4b4ee320f09dea93064ce1b9697c67ee3e134	2388.6132	18288452.092400174432667433	3913605	53	0x4567062cd9180f9449d79783755034fb1a56b0f517c9ace9e95da888fa00f896
1513	0x0000000000000000000000000000000000000000	0x4d9b51c87bbe085b4416c95fc497d2c91ef1e585	9573.6	18298025.692400174432667433	3913609	31	0x07cbbebc39c33ce0a76c30bde1937f475e8a059e22811f950a0bf47a7edd595c
1514	0x0000000000000000000000000000000000000000	0xc62435340b544481bb309fd4f345b46c80c787e1	330.2892	18298355.981600174432667433	3913609	43	0x843c9fc6a522ea95cb0c48e42a4a9bb0ab12a5ea618a7434677e246b9a9b9dca
1515	0x0000000000000000000000000000000000000000	0x6a63fc89abc7f36e282d80787b7b04afd6553e71	2393.4	18300749.381600174432667433	3913609	62	0x6524beab056318b17a37788b44c968fee1e919c050c32773b9b84f6997ee2fab
1516	0x0000000000000000000000000000000000000000	0xfd0a5779bcfbe5aab59ad4c202a52cf1544f1c99	957.36	18301706.741600174432667433	3913610	72	0xb425cb46154fd145e18315092d5573c8104121a249138e4e027faa9cfb0f116b
1517	0x0000000000000000000000000000000000000000	0xeb470f1fb60c2a2ed7378b5621195e60d7bcc3a1	9573.6	18311280.341600174432667433	3913611	35	0xc5d1b0f3eca35de429fdfa039fe34bd31e578c2077931eabe0d61aed16580b12
1518	0x0000000000000000000000000000000000000000	0x6a63fc89abc7f36e282d80787b7b04afd6553e71	1914.72	18313195.061600174432667433	3913616	47	0x114dd98dac90012aae86566a51ce5d3fcd8591d7eb6e4d71d92347b49c83da37
1519	0x0000000000000000000000000000000000000000	0xbd74bfbc361b6e9ad1b26e1ab62f1fd38c62ec98	2866.81452	18316061.876120174432667433	3913616	48	0x12748cea13168eb8e1348ca083d241a8d8e20cac67b205e332e9c3ff3ed2aaf3
1520	0x0000000000000000000000000000000000000000	0x654ae9a08e15cea8d7d8bbce09f06ccc1cd8024a	2393.4	18318455.276120174432667433	3913617	19	0xb7b415acde1eff1552fd61ab714cc737d1bad3954d0f263f7fa76575111edcd7
1521	0x0000000000000000000000000000000000000000	0x81231070ce6c42fb53cd7a3346cb356cf40b5874	718.75310504885063184	18319174.029225223283299273	3913619	14	0x0efe59a40528cc0d3580c4744966be7ddaf2f0d9f7de912c6911f9782a8f9a3c
1522	0x0000000000000000000000000000000000000000	0xa679f69aafafc517138543eaef57a6ac7acfa3fb	5744.16	18324918.189225223283299273	3913622	4	0x985149a9d959caed2c67c79a11ec4d7ff13bb29f8592ddc632b66add6691a0a0
1523	0x0000000000000000000000000000000000000000	0x57b90d9d521f8f8b2e16442db0a716c881b64c5c	478.68	18325396.869225223283299273	3913622	7	0x4952f097b98d8ab3e8b94f7596090592e8a67927157e7da99ac7e3cafc11b96e
1524	0x0000000000000000000000000000000000000000	0x006c6af83451fd0a360d61e2c8a6f55fa82a5e2c	4786.8	18330183.669225223283299273	3913622	8	0x781ef7f57b06882272d1fef4df975e05271c999f2b7e3968a58de42f6a4fa60c
1525	0x0000000000000000000000000000000000000000	0xbc57c96280f33d9a860f75d31fa76f51645b1b59	282.4212	18330466.090425223283299273	3913622	35	0x8ba73128fb1ae9b7bf22681c548505408c6efeacea0648771f0ce34040ae6a65
1526	0x0000000000000000000000000000000000000000	0x0ad30cce08e30bc44680bf76862c04ddd7ea1f5c	47.868	18330513.958425223283299273	3913622	58	0xecd1ca1db33f46cecfa994d3080a409d7664e017b1a03b8f43dde88eb9a00f52
1527	0x0000000000000000000000000000000000000000	0x4ef810b755d19d5d7a6dfcc5a663e20e7d92d905	95.736	18330609.694425223283299273	3913622	61	0xd96dd4bb1f670525fc21bbadea7941d7d4fd71ec21563e1c37ef7352678b0c1c
1528	0x0000000000000000000000000000000000000000	0xd8fdfb5b61b8a5b39b1b678b5bcd89c28ece1f02	167.538	18330777.232425223283299273	3913624	25	0x8b6ae8ff149ee9a44350f9af4ddc94d1ee9216da8b98a8014ebec58695c5d447
1529	0x0000000000000000000000000000000000000000	0xc801244c5f39711400dc52e99cbe7ae5ccc0e23e	1436.04	18332213.272425223283299273	3913624	27	0xb4bd798e11a92eec7e5cdcb9bfacd97e8a0775fe2c5d54f25486dfa7ef6731b7
1530	0x0000000000000000000000000000000000000000	0x326619fd3fb4ea3a62589d27d1b9ebdaf89ceb5f	71.32332	18332284.595745223283299273	3913624	29	0xdcb04874368ed3a2af1b6403ff039e02e2e748ca52b604702a62279c05aaf657
1531	0x0000000000000000000000000000000000000000	0xb178bfe776bb2bcfb4016ecacbad41bc6dd037a8	7898.22	18340182.815745223283299273	3913624	45	0x22e1f34efedd673f53cf145d0110edf857fd9d768712e3103190b05ae387d2a6
1532	0x0000000000000000000000000000000000000000	0x650c448a0b3337801d17745216359d6e550b7dad	3824.6532	18344007.468945223283299273	3913625	0	0x595fce9075a3a7470d82aa6c59ac1149431ed7472ba510dd810bde423adfd6d5
1533	0x0000000000000000000000000000000000000000	0x8206027b0a491119ffdb3b76719a83482923b0a5	229.7664	18344237.235345223283299273	3913625	11	0xc78a653e8cc66914b73f166d6a83383f5841b5be1e784485751460f720e98ca7
1534	0x0000000000000000000000000000000000000000	0x71279c50a3e76d46c81203334c740b9453aa02a7	950.1798	18345187.415145223283299273	3913625	13	0xfe3784e234f90ce39c3d92a4e8a25a706c8715ceb9eef0e7f3f1f4deef84f872
1535	0x0000000000000000000000000000000000000000	0xfb4c47e2d80bf8d9ba732f374cb7cb9e38757896	478.68	18345666.095145223283299273	3913625	15	0x3aa18c13aa45cf62ea86ee19f4526279b9d5c1467fcb53e4de8d107adee7fe5f
1536	0x0000000000000000000000000000000000000000	0x3bcd2d9c796c0d5d0e26918d78b81366fd284861	47868	18393534.095145223283299273	3913625	51	0x6be6c10c9c889e23fb1918e8b72c117dd49603425d4eee07ba7d0a6741825257
1537	0x0000000000000000000000000000000000000000	0xcef78f9a51da9d7630e14455b8c833cc9c6918d1	52.6548	18393586.749945223283299273	3913625	53	0x739fc0f0c4284b288860bdf609bb26ef54a3e765932ba1878d522cab0140ab8b
1538	0x0000000000000000000000000000000000000000	0xf909963761d1b4a4e9bacaf3f1dc7d43d9155fff	478.68	18394065.429945223283299273	3913626	12	0x16e52b09f4892a79d2cd364071422e1a2c6ff562cdeba7bf1383e63a468eaec9
1539	0x0000000000000000000000000000000000000000	0xb4848ed01600d5002e2cfd21d70fd7a77a7e81ec	1436.04	18395501.469945223283299273	3913629	0	0x6b7b3ac0528ac6798f82633faf181e93be19d25063e0547a30e02dcfd6f59ff1
1540	0x0000000000000000000000000000000000000000	0x595a74e221263bb53cd714b85e4252de8e3db557	957.36	18396458.829945223283299273	3913629	14	0x8077fc8a16615ea96a90157a982711c89694306f9b5f7fa08471ebd012fe02cf
1541	0x0000000000000000000000000000000000000000	0xe646eae23739b904a0c6980d9f1e6bafec7e85ef	2393.4	18398852.229945223283299273	3913630	53	0x475fc2c2c7f8845919f2092fc1b7e8edfd9a825e6ed0b0ba3fb7b30adc633a38
1542	0x0000000000000000000000000000000000000000	0x3bcd2d9c796c0d5d0e26918d78b81366fd284861	47868	18446720.229945223283299273	3913631	30	0xf577ac71d07a391f334e957e2a551d8ebaff1c2d431f0f04c30785d2b682747b
1543	0x0000000000000000000000000000000000000000	0x7bd2f36b73fc3a09cdcd04c7aa7160b5b14c04fa	861.624	18447581.853945223283299273	3913633	10	0xb5f0a389ff9e315f81136c7f3382775a853dec744e6842236f82be72f2e4ba1c
1544	0x0000000000000000000000000000000000000000	0x1afd4a16a663f770d61e8e34ccfb77931d60ed75	718.02	18448299.873945223283299273	3913633	21	0xd51cdfde7e56f6f9d047f6e8a2776679e1a85bc3104cff25292f97053b558274
1545	0x0000000000000000000000000000000000000000	0x3bcd2d9c796c0d5d0e26918d78b81366fd284861	47868	18496167.873945223283299273	3913634	32	0x9c66a6b9e1160130ae7bab81f5024c449149621b8fcfdaa0964d99048d78f415
1546	0x0000000000000000000000000000000000000000	0xe3c8288868260e13cfdb3c38d7cc2f739b3f5084	957.36	18497125.233945223283299273	3913636	19	0xd6985635cdb5d3b35dba7a1a5af0de5b45d6b9bbd4063f5dd22efcfc2e05e253
1547	0x0000000000000000000000000000000000000000	0x76c5661c1c65820df706d67917a288c39a37f627	236.9466	18497362.180545223283299273	3913636	28	0xd779d67be23a8b954474541b45634cf70f15670b0e148d8963a558fe55a6dfef
1548	0x0000000000000000000000000000000000000000	0x8cbfd6e5e10c9617bce29f32bb2dcb9b317a4bac	239.34	18497601.520545223283299273	3913637	2	0xebcc7e5383c5bb688e0af163e5ba64bd5fb012736c1e530d40949018ab37b61d
1549	0x0000000000000000000000000000000000000000	0xdd1b5bee1fd3469cba598892e3d2c070a8e97020	478.68	18498080.200545223283299273	3913639	4	0x456b1bbcb51ca32880c02da0b28005cd106e92036b17d5c8c8ee805f11a252be
1550	0x0000000000000000000000000000000000000000	0x3bcd2d9c796c0d5d0e26918d78b81366fd284861	49670.4409532304	18547750.641498453683299273	3913639	20	0x8fd5de7804a471524733634121600124a5a7b2ad16607fa3438ddb08360abc09
1551	0x0000000000000000000000000000000000000000	0xb62501495f4143435033bea49e8bd7fbb8b47430	4786.8	18552537.441498453683299273	3913640	1	0x3b61562e9cb06d856628397c12c9b14aa3aa9448bb58113f96072103a003a3ad
1552	0x0000000000000000000000000000000000000000	0x9bdc8a84bcb554f02f540c2ea16e3783405ab06e	2872.08	18555409.521498453683299273	3913640	2	0x8b5d464bc4ef73141b7a083c7800f441a95a5eb652692c7e5843a7b608970b99
1553	0x0000000000000000000000000000000000000000	0xfdbbeb9f45e5bc457e8f5693cb3e57512924fb30	119.67	18555529.191498453683299273	3913644	4	0x19cc896ab813b77ad528f1e358780da018fb595c1880d5133c7fb7feccc57dd4
1554	0x0000000000000000000000000000000000000000	0xce801037094b65584d3b1852d3ab51b71fba1ce5	33.02892	18555562.220418453683299273	3913644	30	0xd35072ac9a70295787079e9dc6f74ea719908303673cd1d2b379e4345df01c7a
1555	0x0000000000000000000000000000000000000000	0x2e1483d8bdabbf80ebff8e3a72ce1e8fbe16d343	7180.2	18562742.420418453683299273	3913645	5	0x7e597931d61efb5c08b66af1a7e54071361092517b36c38dfe557b0e99045973
1556	0x0000000000000000000000000000000000000000	0xb55b646dd24be6d3fb5315568e991e3cc71fb517	1771.116	18564513.536418453683299273	3913645	43	0xfac97fdb46cd944b047accbae295e4c2a9514a72879acac3b358428647bbe5dd
1557	0x0000000000000000000000000000000000000000	0x32617dc601160ee0204de051737c83c8d81bddf8	4786.8	18569300.336418453683299273	3913649	13	0x9153118e54b48cdc9f9aa2397654bfb01b4a0d971590bb494e95b47da6b168f8
1558	0x0000000000000000000000000000000000000000	0x31093194d9ddfbf3259543ec9020269d262adbe6	339.8628	18569640.199218453683299273	3913649	30	0x0f4ea2f327cbb4c7df05302a723b1a82f4867c628c35f4f465946a433ed8cb0d
1559	0x0000000000000000000000000000000000000000	0xabb0bd1360234c633d2589df384e4cab0272ba17	3829.44	18573469.639218453683299273	3913649	35	0xbd0a66a4a8c5c39bf9c1cc0fb267616d3d524bf05962cb0db72873196105afb6
1560	0x0000000000000000000000000000000000000000	0xeaadb8e3430499393cd5049ae01efe8ac7bc93f6	3.61585489872	18573473.255073352403299273	3913649	37	0xf2a0b83ee431bd5d389126298dabafad72563110128476af7cb6080ed3e36f02
1561	0x0000000000000000000000000000000000000000	0x007657e23dcf0ebfa1e4841e375158941f58fc0e	4786.8	18578260.055073352403299273	3913649	61	0x89a5370dc361f01c5fb4ed11a63b3552580a95a78b89a441ff03a599c44de215
1562	0x0000000000000000000000000000000000000000	0x469d6b2819d2040c853251281df0e46f932d789d	478.68	18578738.735073352403299273	3913649	64	0xb3f98d9828a159e6284f2f0295b06bb77b4d141ad76cfdc6ce44183a3f4afd5e
1563	0x0000000000000000000000000000000000000000	0x5c27735cdb5831f181fa1f1a94b65be1e3629164	47.868	18578786.603073352403299273	3913650	13	0x09e37facc9decd7edee568d5b5850946a47f376ceef7e0410df22b591623c4dd
1564	0x0000000000000000000000000000000000000000	0xffb6781148d1f2b6415c25dfca2ccafcab4099dc	4255.4652	18583042.068273352403299273	3913652	3	0x4c9ad65bf8b3413a7218848ed47bfd29d0f6cf1ee008f36937b565be1e8a6c4b
1565	0x0000000000000000000000000000000000000000	0xaad178f2f688878dd0db6683860c542ce8c5907a	7180.2	18590222.268273352403299273	3913652	13	0x5903b600f38a48bc621ebaad3ffc66a182437d7cce2100ee58d68b29bcf60473
1566	0x0000000000000000000000000000000000000000	0xf480d2b663d5526f613a3d2b2b6b996d455434f8	90.9492	18590313.217473352403299273	3913654	4	0xfe39c55ca1b821a007ad019aeef7fc8a7f5ef225151bd0af5370fe4652f5ba2e
1567	0x0000000000000000000000000000000000000000	0x7e515d8d787628ad484e1f1a1903fdf2633fee66	957.36	18591270.577473352403299273	3913654	13	0x6af1dd0177931d02d4beabcfaa8e1e3b1058e7dfc9f8584d08b84fc3acba1d01
1568	0x0000000000000000000000000000000000000000	0xe696c7b6d3e719f0befa8a2688619422f339bd5f	239.34	18591509.917473352403299273	3913654	35	0x690ad678c2870c2d1824398fda83b3d88dad61731862b3bab1d2a0063a407f92
1569	0x0000000000000000000000000000000000000000	0x687a5e81b3c337d43f35578873759bbfe8a11ae1	483.4668	18591993.384273352403299273	3913654	61	0x6d538a7ee9e8b3adadbf4aa361add1cb1ff43052a7a678b7a91c61179b346cba
1570	0x0000000000000000000000000000000000000000	0xd81192b3b90e177a243dbaaad29ab4175f4c4215	957.36	18592950.744273352403299273	3913657	54	0x0c7b245540fe33ff7a4e464ef13fc5c63707b8e2d5f435f17cd52339cef42f28
1571	0x0000000000000000000000000000000000000000	0x8394a052eb6c32fb9defcaabc12fcbd8fea0b8a8	478.68	18593429.424273352403299273	3913659	12	0x3b17590d32f90aef45917f803766d4eac2dbef7593ea0a6958bd0b78de8fc300
1572	0x0000000000000000000000000000000000000000	0x4501c3efc7004ab301071156f371fde9d0ab2572	2872.08	18596301.504273352403299273	3913660	7	0xadbb2a9d08d3f4259e15d9069f65507b0343e686cb1996ed9ede7c38a276206d
1573	0x0000000000000000000000000000000000000000	0xc74aca7e80610f51c382b1dc679ab8ef6c1c613b	478.68	18596780.184273352403299273	3913662	11	0x75b80ff2ee5960ac2e49b2141a9c30b7b496e13a4ce4d7fdff01163d8452869e
1574	0x0000000000000000000000000000000000000000	0x86834a65e12fc6fa4b564b8d0f6b98a4caf88f50	4308.12	18601088.304273352403299273	3913664	30	0x3f241685ba87b70238bcdcede79ef8c0c14903600923857cb72d31ee6d784170
1575	0x0000000000000000000000000000000000000000	0x31daec3e09ba0e094fed5d40ad7d51e312f41b8b	1436.04	18602524.344273352403299273	3913664	40	0x6296411d79fca137af05d593842434518b8384840ba59efd49d60ca042331a31
1576	0x0000000000000000000000000000000000000000	0xa3ad36e5db826b1ec0bbb6276dd9924823c291fc	718.02	18603242.364273352403299273	3913664	43	0x6fe7e42a067f3d0b9ce1975d30fc22a58f7c98d5e40da18282cc48ec78e78f3e
1577	0x0000000000000000000000000000000000000000	0xcd9a536b42243b9e3bff197efc842ad5773671b8	392.5176	18603634.881873352403299273	3913664	54	0x515f3b8ba56b5d287dd1aa2192c311abfdd98e03d52dcced6321d52706efcde7
1578	0x0000000000000000000000000000000000000000	0xd4cb7fd8e2b214596c1cbd4ba0f1c701fbf2bcb8	95.736	18603730.617873352403299273	3913666	58	0x13ab8f6800073786fa3c7240af044aab5658da58f2becafc0376951e92d6af8d
1579	0x0000000000000000000000000000000000000000	0xb8760a26c40ee73420294061f6e3a89ae050bfc8	1459.974	18605190.591873352403299273	3913669	40	0x327670f38b7f4dab46596d56b43830c46eeead89d2658981a9e082e9f5826efc
1580	0x0000000000000000000000000000000000000000	0x6a4cbda9e03d316720c3c238263eaedc910beee2	1483.908	18606674.499873352403299273	3913669	42	0x706206eb097686bd56e06d6d07b11fbc30101c97e66df7134370d76b9ef11b2b
1581	0x0000000000000000000000000000000000000000	0xc57ea67750ded06a98763d5251f062785eabf8f6	153.1776	18606827.677473352403299273	3913672	24	0x46e63f5aefbcf3b20de9510b080821e42afbddf8ffc53374450c3085081bbe5b
1582	0x0000000000000000000000000000000000000000	0x7fcccd2cda09d48fc6775f802b535ed504d721dd	957.36	18607785.037473352403299273	3913672	25	0x201cb18c0b53381819524fd6e0050b484e8df70dedd8784a45b5e35f36b82fb5
1583	0x0000000000000000000000000000000000000000	0x469d6b2819d2040c853251281df0e46f932d789d	478.68	18608263.717473352403299273	3913673	3	0x1b8f0186dd052a9fec90d51e223b758bacddb2a249ee8b3f157fdb0442595b88
1584	0x0000000000000000000000000000000000000000	0x5f2fdfdb7945f770436d1f41c01b47fb76313a39	1914.72	18610178.437473352403299273	3913673	4	0x4d47860ada0039410cf57bbe2651d1011c0a63df8cc51d8f6fbbbd2caa037567
1585	0x0000000000000000000000000000000000000000	0x82e9934b06af36bc458157db18148f2c24d0855d	478.68	18610657.117473352403299273	3913676	8	0x010e4fa52c02b2ec0881c8ced119eb33be8cc770dd7fe929b38943b9384d4d51
1586	0x0000000000000000000000000000000000000000	0x6a8daba7928eef38ce09eb7bac23ee964766085a	1915.67736	18612572.794833352403299273	3913679	42	0x2f481c67b3dd7e20f1cb073df451c2a7754e3715c816467f004c392f2a27f0a7
1587	0x0000000000000000000000000000000000000000	0x63f6fc9ee621994568691a3d332789755414a3fb	703.6596	18613276.454433352403299273	3913679	47	0xc9268168fe37952303ac624009d8bae50849db100d159fef1d4182ab440a989e
1588	0x0000000000000000000000000000000000000000	0xf2ceb5e7cb5fbd550a2ee30500ece3a13721b0de	239.34	18613515.794433352403299273	3913680	25	0x0fb63065f25d3359c1c61e36bbe323af12e268ab9c44929644b3bd36d811cc84
1589	0x0000000000000000000000000000000000000000	0xbb4b5a7365724b93efb22fadeea2927cc9a2091f	47.868	18613563.662433352403299273	3913681	19	0xb54a1bb4f8d4bf5552a1a1f80c78d6312bd99a44dbc08ea8cf758ef766e64dc5
1590	0x0000000000000000000000000000000000000000	0x01f5be9fcc63bb4ede40e89db317d507c5adf81b	2393.4	18615957.062433352403299273	3913681	27	0x339c04045bd4942493244096c3e6e031f90d130bc1be6cc6a8dc4836b62ac117
1591	0x0000000000000000000000000000000000000000	0x27a5be7e0022c7068be35acdde5df3e5df5fd16d	718.02	18616675.082433352403299273	3913681	34	0xb3a7096e9d9b19ac02ff195d1f42b27da16950c71b34ad9fe8d6c13c868049f2
1592	0x0000000000000000000000000000000000000000	0x8f6e7930cd50ddbdb1ffb019488b06a6accf19e5	2393.4	18619068.482433352403299273	3913685	13	0xf5618e312a9d40eb43660e24151a6647a33298fd9185599b8b80b0f01a3fc396
1593	0x0000000000000000000000000000000000000000	0xeec871ca68f0bab89c11255a40d26d6895915acb	478.68	18619547.162433352403299273	3913685	38	0xa714df2260a7db8ffdb2c4c56479ec5bd21ef909fb727e87f5eaeec3a0c2a0ec
1594	0x0000000000000000000000000000000000000000	0x4bddbd1cbe7aaa14d1461178e2cf4943c12fa20b	1079.2465971486	18620626.409030501003299273	3913685	42	0xdf6b2138f6468088fbd971f21eecb1f48e84a2ded8c95e267a447ede7279d82c
1595	0x0000000000000000000000000000000000000000	0xdebf766e1b81933c430366daa372aa7ac8a7d3a9	43.0812	18620669.490230501003299273	3913685	51	0x0dcc903fe02b2b8430944c5d5d377de5990b273f610a4412c69984f87c62d3a0
1596	0x0000000000000000000000000000000000000000	0xbaf1e9cca2f0ebb7e116508f39afd8e730e23e45	1675.38	18622344.870230501003299273	3913686	3	0x001a8730ff37d5b81161c810e5af339ec35015e8c9e019c1596a4cbb8a08ecec
1597	0x0000000000000000000000000000000000000000	0x527a0b3ece17c5aa90f6a4d9c2354073d24fdf94	941.5348392	18623286.405069701003299273	3913686	7	0x6a16fc619e2c3a3fdb7bdfe975841922c3945c7486093819a12cd70eba360bb7
1598	0x0000000000000000000000000000000000000000	0xef15288173a751cad574132dbba558db30e14fca	997.56912	18624283.974189701003299273	3913686	13	0x37c853d14df8381f28e63477632dc436be0d609468b8b56b3b4fe1a0a349f954
1599	0x0000000000000000000000000000000000000000	0x41aab658d1ad2e8ef41f36337c0d3ad126f2ed48	718.02	18625001.994189701003299273	3913686	57	0xf10ba4fe80d0159d5efb0eec13f1b5940c28c1abd0efb80c7dbe27e12018d647
1600	0x0000000000000000000000000000000000000000	0x004dccdccd989fe30ebb6abc304cebeca438fa2b	478.68	18625480.674189701003299273	3913687	10	0x4ab0add618b046e6d6db4ac9cb2ddd1d1dfe2ce7852abe7fbb105a83d9b474dd
1601	0x0000000000000000000000000000000000000000	0x16fb4dafc6d06cb296e5b3a1c1fcb26285c07ae8	1531.776	18627012.450189701003299273	3913689	1	0x9e091e95006e07dcb5e6ab83c0adae9ba282f209b70d588b8fd0f9b47f9dba97
1602	0x0000000000000000000000000000000000000000	0xc649f89d4f4521fc15aec3b8ad55f209f1a9be7e	718.02	18627730.470189701003299273	3913690	7	0x8045f86f0ede881a07b1db79038671d5707a03e74d135dcb1c8c9c336057dfc3
1603	0x0000000000000000000000000000000000000000	0x62adccebb1c019509a64e3b120db4e9a0293b08c	718.02	18628448.490189701003299273	3913693	6	0xb0e4268f765f482f274e4da5cc539652c1f24f726f75fd65bd52b0f283960a31
1604	0x0000000000000000000000000000000000000000	0x41df3c996371a877662acbf3888f8f332f603fad	47.868	18628496.358189701003299273	3913694	16	0xc99c2332f6fe3dc87ec60d881ebb09ebf385d08683606c3a0690351e067d867c
1605	0x0000000000000000000000000000000000000000	0xb275e7b4d1d54a9d22c364791773dec90bf02437	2393.4	18630889.758189701003299273	3913695	29	0xa5e4faca0cebdbf09635757839dc8159710eab0c228a43ee96370a77a905e11d
1606	0x0000000000000000000000000000000000000000	0x8610a01802f4e530ab19b5b6c6e69ecbdb5232ce	952.5732	18631842.331389701003299273	3913696	0	0xa8ed0994066b816cb48323be7fc50ce46aa69a14e03ecbe2918e748e45ac3bab
1607	0x0000000000000000000000000000000000000000	0x202374735d4a2fc3ed4ad3880591f906ca257417	1579.644	18633421.975389701003299273	3913696	68	0x211e75f2b11ff317732846f8bec2ddbe72e9b66043c078485541d98a610c6719
1608	0x0000000000000000000000000000000000000000	0xbb4b5a7365724b93efb22fadeea2927cc9a2091f	303.53020679424	18633725.505596495243299273	3913697	5	0x1e05c4fe2d6542365e0642f71af7c0a1b31d96397b1c737b6920d412e31cb2a2
1609	0x0000000000000000000000000000000000000000	0x317ac5d644ed4a12369734ddc422483c6f21b1e5	6222.84	18639948.345596495243299273	3913698	29	0x1e4dd27a8cceacd6bc30c577d29dc2025de9288e150a3e45504a6f322ed04f16
1610	0x0000000000000000000000000000000000000000	0xd63c5d4de6bd64555e54bb193038119eb0600e0b	1914.72	18641863.065596495243299273	3913698	49	0xa47fbf1a682f049f3b2c9f4829bd8db2f1b7bfaab153599e7c6d969116df55a8
1611	0x0000000000000000000000000000000000000000	0xc0cbd93be551016e000482a32c91402af64e587d	95.736	18641958.801596495243299273	3913699	2	0x294f4644d8c8506dcc9d08d3a7492709d9c34f8e884027956fd731c297f7e5e5
1612	0x0000000000000000000000000000000000000000	0x30995f6c74fe399e974afc61588197cb3bfbe20f	502.614	18642461.415596495243299273	3913699	26	0x78e3996d84dab73e07d4e3ed8eefc8c36c0b1afae0786e5156be9faa79f0d5f4
1613	0x0000000000000000000000000000000000000000	0xe4e382e89117144c7ee246e28395f9e6cdfd0b15	7180.2	18649641.615596495243299273	3913699	27	0x2f3c68830178e6e4410c93db1d259d8a0809234ff1f265f8df67a23a0be550ad
1614	0x0000000000000000000000000000000000000000	0xef53911cdcb32fe0ea65531b02091b4b5769e9d9	234.07452	18649875.690116495243299273	3913701	5	0x0a5e6f60b93def14fcce5e053bdfa9df73affb6934f7e189471ef96fb156b642
1615	0x0000000000000000000000000000000000000000	0xb62501495f4143435033bea49e8bd7fbb8b47430	1914.72	18651790.410116495243299273	3913704	0	0xc5923b9b5ff0e124d8c6485628b001dd9baa103c08f5b9204fb710e6a3e27dfb
1616	0x0000000000000000000000000000000000000000	0xbaf1e9cca2f0ebb7e116508f39afd8e730e23e45	1038.7356	18652829.145716495243299273	3913704	13	0xdb6a47cea1d041d6f00c467d5e1a7ebd724a303f09fd3cbfe3f3622d8d9f7417
1617	0x0000000000000000000000000000000000000000	0x54633c702ae5c9184b1a8c7266aebfdc7ae89f2a	239.34	18653068.485716495243299273	3913704	111	0xc332b56bd8c3cb58a81d157063add232fde7046c6d3ce8842b0e8d04c8507101
1618	0x0000000000000000000000000000000000000000	0xaa738eba50c492d802a0c559423a3c12348d4dee	2872.08	18655940.565716495243299273	3913705	8	0x65edf1f9c5e7c2327fca93d62ef9923a3e74de4be712b24a0874a7e6aefa3d59
1619	0x0000000000000000000000000000000000000000	0x98b841ea365cf9af0e85e57e9f4e26e3a1d9964c	497.8272	18656438.392916495243299273	3913711	17	0x169b6c25d2e4c1519e07b32fc06dbb8cf9a6c3cae6dcccce7c71a5cb63264fbb
1620	0x0000000000000000000000000000000000000000	0xae190349d60c20e07b6f60f1063e1e0c0302bd6e	449.9592	18656888.352116495243299273	3913711	18	0xbac3e6e51e0a762dd76fe82b839a76d2516b7a5ffcdb7d650b4610a50270f914
1621	0x0000000000000000000000000000000000000000	0x32617dc601160ee0204de051737c83c8d81bddf8	1675.38	18658563.732116495243299273	3913711	32	0x473baec749177bbbba33359ad0c5aeffbdf5f966318c08cad35313bf2d09378d
1622	0x0000000000000000000000000000000000000000	0xa02386ac687d0dfc0da0a72380a27e0259014859	478.68	18659042.412116495243299273	3913711	35	0x4a4d3c2b8e2706c9c5f7c04173d378fb2cd9f03508d0e666cb27ac939d23a52f
1623	0x0000000000000000000000000000000000000000	0x98527d19b26f6a46ea5d4e96630750307aac2e31	473.8932	18659516.305316495243299273	3913711	58	0x0933a722fcfba1e905445f37a7904ff1b39be84aed2fcdf39eff2deed11b64e2
1624	0x0000000000000000000000000000000000000000	0x225f6734c8c3e0731b5a5315a5942e8ea63431ec	957.36	18660473.665316495243299273	3913717	39	0x031b68eb963cbf1b3574dd95702c1636429a633d6fedad42cf354d64e01ade94
1625	0x0000000000000000000000000000000000000000	0xe1d26d4a34e992c2172140718b7bf4fa1e9fbda1	1196.7	18661670.365316495243299273	3913717	47	0xe37ed0e1035892beefb9a4b1e0353f1dd09fc1280deb50814fec7f3c80469938
1626	0x0000000000000000000000000000000000000000	0xc86742607f712394ac5bcb78c39c9b1396d00777	957.36	18662627.725316495243299273	3913717	50	0xbb688d5976e2b46e617114d2cd8711b00cb34abb9a50441582d0b77a7716a6ec
1627	0x0000000000000000000000000000000000000000	0x53e48e09c42b717906e8f0e7cf562af347877787	1924.2936	18664552.018916495243299273	3913717	57	0x1bbba4840b2e8ebe49f65996b432c811b41228313707c9f688150d8cc57430f3
1628	0x0000000000000000000000000000000000000000	0x6d078f008999e2fa0ab2f792ca654f5125f4ccaf	215.406	18664767.424916495243299273	3913717	63	0xe5bc4e9bbaacee8eab22708c63b93f02985a78000dc70c7ef0c272e504430ccb
1629	0x0000000000000000000000000000000000000000	0xf480d2b663d5526f613a3d2b2b6b996d455434f8	756.3144	18665523.739316495243299273	3913718	52	0x37dd21a4ba382daa0b89fcc42266149cbed356ede1e38ba1e54025072975266d
1630	0x0000000000000000000000000000000000000000	0xf358406e92c686fd3af99115a7b105783e4aa039	11105.376	18676629.115316495243299273	3913719	37	0xf5332bc7b04439cef0b806dce84af712d574dd423d41f0962cbe278f2288a2cf
1631	0x0000000000000000000000000000000000000000	0xa563593116a7f9ab359e3e0f9cf49cb10c9828b5	71.802	18676700.917316495243299273	3913719	52	0x194e6d8d2f304de1bc55e2c637412c2f276f200a2080063ebf21fce332918862
1632	0x0000000000000000000000000000000000000000	0x163b041e1532c4aca1f25cb8aa39e23bfbd1048c	344.6496	18677045.566916495243299273	3913719	55	0xcc608da1820849d691ece9143d0fd88245f3023b8824b40a19813f70f326aadf
1633	0x0000000000000000000000000000000000000000	0x8610a01802f4e530ab19b5b6c6e69ecbdb5232ce	957.36	18678002.926916495243299273	3913721	58	0xf8fb48b87def544f6ee833f3a71b95ff742174e92e85a17bbeb400e7a37e4931
1634	0x0000000000000000000000000000000000000000	0x9df712a77bed41fdfc97edd44ecfafd76d0bc2d0	383.231208	18678386.158124495243299273	3913721	66	0xe49f046812d17c32e763e4bdb88b501adc056c44bde68d066891f9c87d27aa0e
1635	0x0000000000000000000000000000000000000000	0xe207d0ade12c69ba9616bad8cd404733103a3c0e	4786.8	18683172.958124495243299273	3913721	77	0x5229327f879bb28cb13770dcb4e6a34a0ac454c7505ba00448d8ce2421e2a37b
1636	0x0000000000000000000000000000000000000000	0x2695807fb3985968ad747bfa6a3bf04f1f341ee2	478.68	18683651.638124495243299273	3913723	6	0x108215ce5928dc5745dcb4a12f789229f3c1d5a9ddb92a44ccbc06c1b5c36a5a
1637	0x0000000000000000000000000000000000000000	0x98b841ea365cf9af0e85e57e9f4e26e3a1d9964c	9.5736	18683661.211724495243299273	3913723	103	0x7f5814b4cb18cebe86f0b97950b91b21a18903f978ce85c04e45622d9b013789
1638	0x0000000000000000000000000000000000000000	0xc95890dbfd5c8120f68f805436af128ae8185440	1934.82456	18685596.036284495243299273	3913723	113	0x9c29c2dfde46be0b1e8e2ed74d48e8ffecce8903291ea6d1850516ac4d117573
1639	0x0000000000000000000000000000000000000000	0x689bf0a3dc57d1432d7aa3a780dc48ad15ca6826	957.36	18686553.396284495243299273	3913723	116	0x44ec9cfb8207f9cc187d1acf887af3af6a2b9e78135bb126408f9d97b9938e75
1640	0x0000000000000000000000000000000000000000	0xd6f7c94c8e82c7e2e1234c636d509d9065b1c36f	191.472	18686744.868284495243299273	3913725	23	0x435cf7e426cc81e0307bfb6661f18c0b30f27e54d266d46a02d66ceb94563afb
1641	0x0000000000000000000000000000000000000000	0xae47b0465e954e67aaedb598267482c1f1ed828d	2460.4152	18689205.283484495243299273	3913725	61	0x91c07a30c6d7b314d33ea6b26ab3911db5e24c4f40b3e3a1d50942c4f38ae2b3
1642	0x0000000000000000000000000000000000000000	0x2107c98fef67c0a2789a38743bf3720b4171b539	239.34	18689444.623484495243299273	3913725	64	0x2b02181bc7ed9ec7c96c8735ba956fb48f5139b404dcae9e5bb08aef1f00d88b
1643	0x0000000000000000000000000000000000000000	0xbc57c96280f33d9a860f75d31fa76f51645b1b59	191.472	18689636.095484495243299273	3913725	81	0x1ba7c6e21993120648f0b5436ba815348ad596cfc61338d23b9b4585563b66e9
1644	0x0000000000000000000000000000000000000000	0x6101fd9ce17e95f1a5451e62aad8c6a92530d64a	2393.4	18692029.495484495243299273	3913725	82	0x5d782c01c4dc43b6e7776704a7d5f45b5a585f00cb164befd48d1150c5a34124
1645	0x0000000000000000000000000000000000000000	0xf2ceb5e7cb5fbd550a2ee30500ece3a13721b0de	11967	18703996.495484495243299273	3913725	84	0x3e029a6409db85f5e7da18ec28e56c710dbe1408c8cd767dfa76d707255ca81f
1646	0x0000000000000000000000000000000000000000	0x4f2b1f63e22cc2b0fc56837816e6eaa7e1320b1f	478.68	18704475.175484495243299273	3913726	31	0x082faef14fdbfa80655bcd9897a768056572dd2435bd3ddbb6099b64db52f99e
1647	0x0000000000000000000000000000000000000000	0x5f2fdfdb7945f770436d1f41c01b47fb76313a39	32.55024	18704507.725724495243299273	3913726	32	0x321803b446131d0c0e769ea21d95b83298da85df986c1d32d635a0ff62361654
1648	0x0000000000000000000000000000000000000000	0x216dd71f6d7af7416dec221a2aa7787573fd3d46	39.52349419032	18704547.249218685563299273	3913728	4	0x2e82f2979e0a971ff089e319401966d393aff5923db57c56df170d1adb2a886b
1649	0x0000000000000000000000000000000000000000	0x00734fc798fbc39d7c9bad21ff0e1bac6410ec7c	215.406	18704762.655218685563299273	3913730	26	0x2d6e3163a10fa6b824a24eb6109f9d0192b71f2a3a8f255ae9062d33711ab756
1650	0x0000000000000000000000000000000000000000	0x8b35acda84ff338233b66997f059164447e71aa4	478.68	18705241.335218685563299273	3913730	84	0x6e7339f2bda6a8e5fb8d6d2deab363780e1d447f0c6155b951eb0b2f37927dab
1651	0x0000000000000000000000000000000000000000	0x0190bce30adce7bf505e5a64a86a69c09c402e79	1914.72	18707156.055218685563299273	3913734	26	0xb58df176bf47e640fa8692d2161c7d43e23fc9044cc62be7eae9bcf75b6bd9bc
1652	0x0000000000000000000000000000000000000000	0xdca8831de5f4e7b26206af2210090c54152efeef	1283.34108	18708439.396298685563299273	3913735	21	0x952b766e962ea43c5eec130ac1513d9a62f0fd9b82cd03a8d6a0b838b1be7d0f
1653	0x0000000000000000000000000000000000000000	0x16913a46264241a230836ca2d56c649e765bcf22	239.34	18708678.736298685563299273	3913736	20	0x0efcbeda45ad867ca30137bf7820931b311fa22a901c05a1c7b27a354b856ec0
1654	0x0000000000000000000000000000000000000000	0x9bf9f530b0f44bb7b4e45550301eb181643d02d3	746.7408	18709425.477098685563299273	3913738	4	0x80ae430a19a46a215854143386d0644e0573797afd6407954c3892626d223bc6
1655	0x0000000000000000000000000000000000000000	0x17d9458de0873121b75878c4c7bf3f14606817d1	14360.4	18723785.877098685563299273	3913738	7	0xcf668008273ade0eb70571416e46de315a6989588b724244b21fb215d449ccd3
1656	0x0000000000000000000000000000000000000000	0xb9a7c3840323d2383f70e4980730cbe57a82ca53	957.36	18724743.237098685563299273	3913740	2	0xd7414ac53cabd7302e1fc5e79642526838d3e406d01cea0ca3fabc2620849404
1657	0x0000000000000000000000000000000000000000	0x6b3fde94a41ab629f70a6900927587d8e8550449	478.68	18725221.917098685563299273	3913740	28	0x1094742a713db63d3906bd35a9afca66a79c64c02f0ccdebf978fc8ca4763778
1658	0x0000000000000000000000000000000000000000	0xc37b0cba21914b943c0f9a25ed1e5e1193498565	239.34	18725461.257098685563299273	3913743	25	0xe4752128c3fd7a2a181b0e02e925780b124608fa70be3324659b042d7c273acd
1659	0x0000000000000000000000000000000000000000	0x90e0cac2b6157359d46408f9c7a5aad50a2c396b	1436.04	18726897.297098685563299273	3913744	21	0x5fd5d41d2e3d338248f1404496a5cfd76141b999588e12f83bac8da9b08b4e6d
1660	0x0000000000000000000000000000000000000000	0xfedc9f20f7d5d37e9840cb2b15b9905ce1d3eca6	4786.8	18731684.097098685563299273	3913747	29	0x1359d8a9ab79ae4464cbba73fa4ea76f16546ffb74e8f7e46046d6fdb32e7e9d
1661	0x0000000000000000000000000000000000000000	0xc824c4f17bde7b5a89e912bf1c3ef2327a83d294	1005.228	18732689.325098685563299273	3913748	9	0xe1fc6f841ff7ea65d3032f04bc9b480042d59ba3a3719af53612f9de1a6874c7
1662	0x0000000000000000000000000000000000000000	0xa08f84e1ea177aa8900d238716c72b999733d92a	1436.04	18734125.365098685563299273	3913749	7	0x19a5ddcd26d1d9f82e643d9b2b6a3c3bcaa461a4676775471f16655fb70027aa
1663	0x0000000000000000000000000000000000000000	0xd0ebdf1ab0f6373746b2c2b9c2999531c14e2cc4	957.36	18735082.725098685563299273	3913749	13	0x9991a39bd05537930cd80a9d967bf3148315879fb9ea22f6b45775043a150d58
1664	0x0000000000000000000000000000000000000000	0xa24432c0405d94e73d72908527613ecb822cfce0	7180.2	18742262.925098685563299273	3913754	41	0xee95149f0bfa7641b09e0223a234afbdf7fe88aabe7f77ff07b868d2f8337318
1665	0x0000000000000000000000000000000000000000	0xb182aac5da406e5ee82e7e973c755ba9e7faa979	909.492	18743172.417098685563299273	3913755	0	0x9e18ff7e36358fbcc67b5b390c1605045aef9dee51733b61913b4d13891b8a1b
1666	0x0000000000000000000000000000000000000000	0xbda76bced2d413117bcf47902ba62bf175680df9	143.604	18743316.021098685563299273	3913758	7	0x46ddcb9c4f1fa1ba392d1ddbaefd62a3d8699e4be63422c58f4e46e0bea3840c
1667	0x0000000000000000000000000000000000000000	0x39a186cbdb161b530174560137236b83dd7e1a98	114.8832	18743430.904298685563299273	3913758	29	0x85619f40881bad6a6587446b4ef75dbf222f905752bba70b781f2e04f970090b
1668	0x0000000000000000000000000000000000000000	0x00f5a14a1c1b25960c734d4c16f956fec5b7384c	4786.8	18748217.704298685563299273	3913761	5	0x432fe9fd91be077059961d2598ec22fdbbf07f0119222f4ca135526f7c82fc81
1669	0x0000000000000000000000000000000000000000	0xb275e7b4d1d54a9d22c364791773dec90bf02437	2193.79044	18750411.494738685563299273	3913761	7	0xbc020036801fd3ac60c63dd733dcfa93777c9928031ca4f6ecb6dc5af996320d
1670	0x0000000000000000000000000000000000000000	0x84545053df2f4c6c22b8f6181891a4f70fee5116	1914.72	18752326.214738685563299273	3913761	18	0xe17cc42a554c209165c533bc544136b02afae122b0dbe7829375f736d883e98e
1671	0x0000000000000000000000000000000000000000	0x61b2dc611b7efee67cab1c874d948d5e1e1db08f	478.68	18752804.894738685563299273	3913761	23	0x7dc864dbb4a5244488b1d0fbcbe7cf22e77855ae74a0ae27968ea8e74b582e59
1672	0x0000000000000000000000000000000000000000	0x70cfbb2b250ab7066916955fa3efd3d264239151	370.49832	18753175.393058685563299273	3913761	54	0x7879ae863e3825525306a02c6750e003b96120ab7735a42eee086ec80d044b0b
1673	0x0000000000000000000000000000000000000000	0x178b75080fa69598c02b302288b2612ed7a49fe8	114.8832	18753290.276258685563299273	3913765	17	0xccba13cf59c28467aaa4e50f207b0db9f951b594fedb79d8c6ccf94584ed635f
1674	0x0000000000000000000000000000000000000000	0x44a8feb29563001cf91b1395e81bc7e4217a2f6b	71.802	18753362.078258685563299273	3913769	3	0xc77defcefc3bafb529e25ea59752bead570f28f53092ddfa73623867363ded40
1675	0x0000000000000000000000000000000000000000	0x90e0cac2b6157359d46408f9c7a5aad50a2c396b	957.36	18754319.438258685563299273	3913769	8	0xe27818421175f3da6ef4fefc2e73083c95f7d297da5bc8dc553a7e798f6c4a78
1676	0x0000000000000000000000000000000000000000	0xe2fb4b8661171324d1813bca593bdb74cfe02138	9573.6	18763893.038258685563299273	3913771	25	0x6f9abe9c9ead2fb8a48a6232a4e5e67bf93878a53fd251e9265727aa1297969f
1677	0x0000000000000000000000000000000000000000	0xbd9b6fe4bee17a242d0ce3e0f4f5211a3177bcab	957.36	18764850.398258685563299273	3913771	34	0xa37126350d508e1bbca8d10244c016abde999e793d5763345bb93a0fc1e297f7
1678	0x0000000000000000000000000000000000000000	0x44d2b054c1b034e066dd98b24a85fe1c4541bc5d	191.472	18765041.870258685563299273	3913772	2	0x0eb5c4113a92c1feba87896aae649af6287897f6719ecb916b07ece0533d7421
1679	0x0000000000000000000000000000000000000000	0xbb4b5a7365724b93efb22fadeea2927cc9a2091f	955.865656776	18765997.735915461563299273	3913773	3	0x9272bebf1bdf5064ab1b2816283520315eff7a116e0bf9d22611ea597db5ad26
1680	0x0000000000000000000000000000000000000000	0x76b0bfc34acdc93459c0f48dc39a3723af413e35	11967	18777964.735915461563299273	3913776	3	0xf6100f61aff10634ecf239617084a7281f0bf9331294d31908947354e877308a
1681	0x0000000000000000000000000000000000000000	0x31cdab05111318f6f5988f5dd773407704303570	718.02	18778682.755915461563299273	3913778	10	0x42397c4ba12413e7c2cff1633a5688037080121e316a07bbb25121bc39444085
1682	0x0000000000000000000000000000000000000000	0x6f9bb7e454f5b3eb2310343f0e99269dc2bb8a1d	239.34	18778922.095915461563299273	3913781	10	0xee8614c3433a68e5d0634cdcb409f19e2a04d7ee36eda193235e07ae21664322
1683	0x0000000000000000000000000000000000000000	0xe0a5e7c00a793564f6ff53fae6b6b50894794ad5	47.868	18778969.963915461563299273	3913785	28	0xa14583fc018c050d658a7cd382c1c2710234d63687ae1e8353aa4b3b32475492
1684	0x0000000000000000000000000000000000000000	0xa0fd28192487df8e328fa9658d0d71de333514f5	834.81792	18779804.781835461563299273	3913785	41	0x1d4de8f4b7044c124af147bc39a79b453a377bbb11dfb9a070fd6e064420a7b6
1685	0x0000000000000000000000000000000000000000	0xd0ebdf1ab0f6373746b2c2b9c2999531c14e2cc4	479.63736	18780284.419195461563299273	3913787	65	0xe831d92b64341b1229c9d27caf7b261c6c4eea24319a0a2a3a4841050558e653
1686	0x0000000000000000000000000000000000000000	0xae190349d60c20e07b6f60f1063e1e0c0302bd6e	1148.832	18781433.251195461563299273	3913788	0	0xd1844dcaa770fb0aedbb7d73a1dce2ce8e03c8b57e2d5ecba2c7d07c58e4f514
1687	0x0000000000000000000000000000000000000000	0x8916b73e83d69305f294f5cb3adcf390209c9e93	818.5428	18782251.793995461563299273	3913788	12	0x03f7497ffd264df69d3eab3588d4545c1b9a7f55efece7707147e19a607e2c97
1688	0x0000000000000000000000000000000000000000	0x25ceac4b0fd802c4b9df7dd7c730d6c25903b11c	478.68	18782730.473995461563299273	3913788	24	0xad05a2c3ac8fa4990a87cc81b60ff8292bb4389deb8fdb600b52335f8c7906db
1689	0x0000000000000000000000000000000000000000	0xcd848d083e0d66f14be3d47668a68869fef4be61	478.68	18783209.153995461563299273	3913789	3	0x2b40b90e9952f9afdadb146e642c0853bb4b5735634dde902f08cd41aa19078b
1690	0x0000000000000000000000000000000000000000	0x969ed662df39b3652017ba6f9a48b161bee3cb8a	957.36	18784166.513995461563299273	3913791	33	0xe1aa1eaddf61136a10fefe11c17d41c6a94c85bd2dbcbd22dbaad16b98b7f4e5
1691	0x0000000000000000000000000000000000000000	0x20cf72bec1155058e6c6ed9c33cc030b07bb1b97	957.36	18785123.873995461563299273	3913794	17	0x0b78f498db34a1afd53990e96eba2c7f10f031b38931dba24b9e7f86b562767b
1692	0x0000000000000000000000000000000000000000	0x4612388d94c89d2070a90d2a09be8872e91a8bc7	1436.04	18786559.913995461563299273	3913794	22	0x1e013938e0c9347239c92dcc1fe411bda1fe69a1322dc1cb1f17d5fd4402b6f3
1693	0x0000000000000000000000000000000000000000	0x4fad43dc44bd35369298e8ebb34469dfbceed788	478.68	18787038.593995461563299273	3913794	32	0x96abc717e415c74d7d5bd509b4569daa4e7fd717420fa24f7be80dd1270f341c
1694	0x0000000000000000000000000000000000000000	0x1a1a874bb99eb7f39faad6af6bc039d0c4ee4c31	957.36	18787995.953995461563299273	3913795	16	0xcd339c2ac27ed291a5dc3f7931f37cdf6d1c9a170160c3557291aae07c9856fd
1695	0x0000000000000000000000000000000000000000	0x8f65212d56de65a0effafafbf6e791a5c016bc45	244.1268	18788240.080795461563299273	3913798	1	0xc8a8f7297e885484558dcef2cede0fdeead7a9e03376d23010012b0c42b63ea5
1696	0x0000000000000000000000000000000000000000	0x5b511d31174362bbe11bcdb0610d0940fedf4c8c	2393.4	18790633.480795461563299273	3913798	18	0x69ec03f563f1bda9f5f685b5d9450511305bd33c2aa7167aad8c8e861d2c4f65
1697	0x0000000000000000000000000000000000000000	0xdca8831de5f4e7b26206af2210090c54152efeef	1003.31328	18791636.794075461563299273	3913799	14	0xa620cb28bf52bad5a2f3ce782efc863d6702be0e9f2b1e137216ffecbb40452c
1698	0x0000000000000000000000000000000000000000	0x005d7e5d250c2a1c82f9231474137399c802899b	909.492	18792546.286075461563299273	3913799	21	0x4cae442529a02cfd7fb3505f881d46d728069be28f57c0ecd406d561d716eb20
1699	0x0000000000000000000000000000000000000000	0x64987f5e56f148a34f99c24af4f7c751adf50b84	4786.8	18797333.086075461563299273	3913800	30	0x7adf0979b4e7f62ab762976c6493419735fa8a9a8ee9825b7f5d930b15502e0e
1700	0x0000000000000000000000000000000000000000	0x54633c702ae5c9184b1a8c7266aebfdc7ae89f2a	239.34	18797572.426075461563299273	3913800	37	0xf291f74e45dd43c5467a846c56fd7dc0bcda24062ddc7fa02e0680b3d725b8d0
1701	0x0000000000000000000000000000000000000000	0xe0a5e7c00a793564f6ff53fae6b6b50894794ad5	47.868	18797620.294075461563299273	3913802	72	0x0a814b4d942d020a1f271cb487eaa8f62df6581a0706067158e2eb3cbbae47b9
1702	0x0000000000000000000000000000000000000000	0xf53c2d61a8b51dfc57dc55f2fa24412c66d989a6	239.34	18797859.634075461563299273	3913803	31	0x036094a81547cc0b8c62a16816d42431faabb348c73301d4683188ea62008fa9
1703	0x0000000000000000000000000000000000000000	0xaacb6c756f623839c6db5202d5eeec21417e01cc	2393.4	18800253.034075461563299273	3913807	13	0x322f72359563dde22cdca6e8c566b9567f44a4584dea3c216eafdbbff2e0b0e8
1704	0x0000000000000000000000000000000000000000	0x8f71bdd5bd13151ac841ec8b91617a246e71e46c	23.934	18800276.968075461563299273	3913807	63	0x604923528309cba8806716cdb36086a668e9c7021e5e638fcd13d03ea104452a
1705	0x0000000000000000000000000000000000000000	0x0dbd0195800386629e154e5251b9ebdffa212362	71.802	18800348.770075461563299273	3913807	85	0xd8f0c938f1056d48a35e797ede3d6a6893d842fd3ad19ea56181ce1ff12fe444
1706	0x0000000000000000000000000000000000000000	0x80ec66ae4c0eeb36d8ea59c9a06c2746592ff8fe	46.913651069326025736	18800395.683726530889325009	3913809	32	0x5878650af18599365610618780c0de6663c129a20997f4f51a8bca2abdeb8efa
1707	0x0000000000000000000000000000000000000000	0x945b43b0328ae115e732bbb32865d56f05f7896c	478.68	18800874.363726530889325009	3913814	28	0x188ff8770944706efd293ab338044a89fd6047292e72924d156b253a3c8461ff
1708	0x0000000000000000000000000000000000000000	0xa77e5a9426f4db7cd70b553ffedbd21ad24ac389	300.084492	18801174.448218530889325009	3913816	2	0xde688ad7f83287ef30a97b559e32cd2355e96817aef35e86e401d3211f4f81e6
1709	0x0000000000000000000000000000000000000000	0xa03d7a42bdd5fae4e7196ee4ff8185c18d0b75b0	292.904292	18801467.352510530889325009	3913817	14	0x262e44828f6a6718ae8974ad2e1df8b10d39e25f7c628a7ae394d33024d1d48a
1710	0x0000000000000000000000000000000000000000	0x5ab7cab83af27a53383d77fa5a7816af9b40e55b	478.68	18801946.032510530889325009	3913817	22	0xbe8df283d71923fbdc860a1729229f22a048fc11ca7732f9ad24ecc8f22ba59b
1711	0x0000000000000000000000000000000000000000	0xc95890dbfd5c8120f68f805436af128ae8185440	1934.34588	18803880.378390530889325009	3913817	24	0xd22051cd3378d472db4b208b3356faa912eaea437e318470bf4327ef2927cb32
1712	0x0000000000000000000000000000000000000000	0x00f41b6d469dbfed324d27e86a66e532e1206223	526.548	18804406.926390530889325009	3913819	1	0xa5f04232ea7de1f1e9250903f4649eeca6d9d0dd517f85af4be479686fd84ad4
1713	0x0000000000000000000000000000000000000000	0x3c535a5e159521e6272c03dad1becce1ff0e88ce	440.3856	18804847.311990530889325009	3913820	0	0x08a1f579cdd08291517a1619187a5beddde98d77e5e11355c2dd8801380b5d3e
1714	0x0000000000000000000000000000000000000000	0x4b731186739844a761f09c6d2a4a89ad28623e5c	0.143604	18804847.455594530889325009	3913820	51	0xb5a0c9e0c58e6eea40a2acadbf1f00668d6a72b6a7b80295c908e96351decd54
1715	0x0000000000000000000000000000000000000000	0x536b68fdbd21dde0f950c51981238c039b48a07e	461.9262	18805309.381794530889325009	3913820	65	0xc3e2a37d133b348cc40b87ec0048803b5f5229747f6c91eef9b656b95b8d2cbb
1716	0x0000000000000000000000000000000000000000	0x318621fa4db0d5b0ce48507de8e95a8a175dc852	47.868	18805357.249794530889325009	3913821	16	0xfce0e31e6f2bf80e45482ecfff04b07070684782bf2a46179629c2697c13f84d
1717	0x0000000000000000000000000000000000000000	0xb35bc970c38416ec038979729bfd9ec92de9ca9b	478.68	18805835.929794530889325009	3913827	46	0xa828a33f43f3483bddda79a5195dc0bcddb6b208092a97bab455ff61bb8802b6
1718	0x0000000000000000000000000000000000000000	0xc0cbd93be551016e000482a32c91402af64e587d	57.4416	18805893.371394530889325009	3913833	4	0x8eac53b55f95465a661ba64c82cca103393eb72a00ea670c867440024cf956c8
1719	0x0000000000000000000000000000000000000000	0xb5418a1c1d6d20f207dd65f748b52c4b45fda2a3	229.7664	18806123.137794530889325009	3913834	50	0x36946762e3be6035ac735d1ccebd55f6aeeac74a73d16c483e015a59de940117
1720	0x0000000000000000000000000000000000000000	0x8e4c17cbfeb8854a69361adee1914ef40130031a	4777.0762045764	18810900.213999107289325009	3913834	62	0xa350d7257ad7dfd7b681a780bb226faf925c81bcc95b528fd0dc3c7e4c4b819d
1721	0x0000000000000000000000000000000000000000	0xd8954b852daa772430564ef5e1958f5e2b8bedf6	478.68	18811378.893999107289325009	3913835	46	0xe7bd9d8368484aa69398c678c09daaaa6c443258cd77f8d4fa2b3d5a84e23b30
1722	0x0000000000000000000000000000000000000000	0x5b511d31174362bbe11bcdb0610d0940fedf4c8c	1436.04	18812814.933999107289325009	3913835	58	0x2160ad68411ded1b7d8f645319c01021e1d68742788f88b33d5c38fef3eb78b9
1723	0x0000000000000000000000000000000000000000	0x8bbcf2883f0f314aac935000fde67b6993540342	2393.4	18815208.333999107289325009	3913835	65	0x413fa805f71b3660598b2c9f2f30c2bfbff57e1bde4f66c1f339f2f06f89bdf3
1724	0x0000000000000000000000000000000000000000	0xb20d03fa60c8569eba45b8b41fec777d75f7ecbc	47.868	18815256.201999107289325009	3913837	18	0x8bf2f5b844d83eec6d12407d65109d9e5c886a91ed3f704a2d56885428f72372
1725	0x0000000000000000000000000000000000000000	0x00f41b6d469dbfed324d27e86a66e532e1206223	16753.8	18832010.001999107289325009	3913837	29	0xb32a148475a11685e50e6798304839f8993ce84caeb2d5e578f33959eb94c6fd
1726	0x0000000000000000000000000000000000000000	0xf7a920985ca424714c548bbf414fbed0bef3b10a	478.68	18832488.681999107289325009	3913837	45	0xd6e755ed55667ec68d509392c42f663ae3b0de30cf3e5ea0b59b96c71818726a
1727	0x0000000000000000000000000000000000000000	0x8dd44711498cf2b4830fe0f04830e9621f4cb987	14.3604	18832503.042399107289325009	3913837	59	0x015cf56c1d2d4e937940cd381fc8a4503893fa67d7ff3839a3c58ca04b04d632
1728	0x0000000000000000000000000000000000000000	0x1fe8a64045bd7b1175e775b526213f957bdab28b	282.4212	18832785.463599107289325009	3913838	12	0x7d9c7bfcc5914c90130e14f7fce44daae11cf0da2356c13b9a4ce5159587b214
1729	0x0000000000000000000000000000000000000000	0xf7a920985ca424714c548bbf414fbed0bef3b10a	478.68	18833264.143599107289325009	3913842	3	0x03e1d37469e81aee0752da74942543012601111221998ba0b3f509c88d8bc59a
1730	0x0000000000000000000000000000000000000000	0xdff7322d46a9b2feff32d351953674ec039f4643	382.944	18833647.087599107289325009	3913844	42	0x2d9d29a21782c589c9c1baacdc77521f4da9e8c54298761fa2a341b3b289e5c4
1731	0x0000000000000000000000000000000000000000	0x1f30d0bd1f225ba5811606242d8d9311ac953d96	7180.2	18840827.287599107289325009	3913848	4	0x76bc2c64c51fd447047c91e36e5467fa0aaed56560a7df0960d47c20557de8bd
1732	0x0000000000000000000000000000000000000000	0xb13eaf90dd83127d7506f40394fa1c7cc57d0a40	478.68	18841305.967599107289325009	3913851	0	0x351daeb87391ae5210bafefec4aeda2b3e2d8975ce9b950ac443e449ff7bd907
1733	0x0000000000000000000000000000000000000000	0xb585a287517e2d649540ee4612f88e43b2013346	957.36	18842263.327599107289325009	3913852	4	0x2ba471e042e9901e6bcfc73b787ad023cfd9abe07e145577558ff10d55f4a56e
1734	0x0000000000000000000000000000000000000000	0x531e6da2c99c55885e9485574bad14e8d9495ff2	239.34	18842502.667599107289325009	3913853	7	0xead81ec24e3121828838476abd2b899346332c83e25b6ed8a5562d7b17601e43
1735	0x0000000000000000000000000000000000000000	0x5ad8b60c8faf2e6395b56aba16a5a742a95b20c6	431.2052164728	18842933.872815580089325009	3913859	23	0xc54ffc73b7453fdc70b7cd93f8b785ccb83086e0860b8e8643ad01a2d7f91b57
1736	0x0000000000000000000000000000000000000000	0x1cf2a2d22e8ca39ddfcf481039601f5ad74a8e8f	957.36	18843891.232815580089325009	3913860	60	0xde34362201e74595d4056f5ba56f90fa5b417f8e2d6d6a5ae29a5231e1a6e33f
1737	0x0000000000000000000000000000000000000000	0x0ffa4468c47b34e032c16f1d8a440e62a51a2475	28.7208	18843919.953615580089325009	3913863	1	0x1206d185162551fd224e53cbe5ec1b728e6642b427ffe717da52035461b55c60
1738	0x0000000000000000000000000000000000000000	0x190bacb622795a1dcc66a81a633e427594e1de04	47.868	18843967.821615580089325009	3913866	25	0x7e3f3df3405ef15f0c01951647e01086231ae41503bb49e216dfc21957946316
1739	0x0000000000000000000000000000000000000000	0x8bbcf2883f0f314aac935000fde67b6993540342	957.36	18844925.181615580089325009	3913866	39	0xd2439e1de7b2bb1df4fdbfd999787cd842b89b8c11788adcbe6c88e12227783a
1740	0x0000000000000000000000000000000000000000	0x945b43b0328ae115e732bbb32865d56f05f7896c	4308.12	18849233.301615580089325009	3913866	42	0x7c4cbad36a8bda00225d147a2ec3db0a94e274b9bc0dff031f3bc911e0c6f192
1741	0x0000000000000000000000000000000000000000	0xed0cf34fbd13fa0bef649518609b83d3f5a290fc	957.36	18850190.661615580089325009	3913866	60	0xaf18007e31cc6871f7b92621a8156c02eed811b2493d5e7bbb0c2783f0456aaf
1742	0x0000000000000000000000000000000000000000	0x37eeed98413fa657086801645b8ff87a8165d3c7	485.38152	18850676.043135580089325009	3913867	0	0xe088ae82e73d4cb3333650a195b0bea675713cb3af3a3429029ce00a234e8133
1743	0x0000000000000000000000000000000000000000	0x4a14a3812111271121139998826d1a99c127be44	1421.6796	18852097.722735580089325009	3913873	1	0x6be474f9b33e7e4bbe6c82022d37d57f6e04b3df880daf77dd74dd837761afff
1744	0x0000000000000000000000000000000000000000	0x8cbfd6e5e10c9617bce29f32bb2dcb9b317a4bac	478.68	18852576.402735580089325009	3913875	6	0x6ffd2eecb6c53f9ef59013a07ac14eca6909803932dc55f1e49774cd28c6a5aa
1745	0x0000000000000000000000000000000000000000	0xbed8d304be8ee4af8bec6c0316c00ac39486152a	2393.4	18854969.802735580089325009	3913876	13	0x7ecec5142d1ca60af6f3c5962816cf84b2669c60e0f53c290642fa6464f694ce
1746	0x0000000000000000000000000000000000000000	0xb48e099ab1330bcf839e149bb4c91ae2e84e0805	454.746	18855424.548735580089325009	3913883	9	0x0cc1b0c5d1dbeaed23f113549739ff4c2670b655619c7ec314bd716bd8a3cacc
1747	0x0000000000000000000000000000000000000000	0x8a35c39db1775a043a9da7c4e9d733fb6a0e1ca5	23.934	18855448.482735580089325009	3913884	25	0x2e3e83ba3979514b739e078bacdc9ac6335af615069ffca739a224afb6367446
1748	0x0000000000000000000000000000000000000000	0x0ad6c1c23516f70a3da12f2c9b5240c6cf82a589	478.68	18855927.162735580089325009	3913886	36	0x6a55853b80d91f955b4cc0ae5c42caecdc94c169041e63ed2491ab671dce4d18
1749	0x0000000000000000000000000000000000000000	0x00b1ecb977a99b4e35d3ae0900f1b4c992ce6520	21540.6	18877467.762735580089325009	3913888	0	0x305fcc496f18d622eb58b653166639ece12f9eb030363b068a582d9fdab4da85
1750	0x0000000000000000000000000000000000000000	0x25ceac4b0fd802c4b9df7dd7c730d6c25903b11c	478.68	18877946.442735580089325009	3913888	32	0x21ba7897ce3bff77718c7eb1f209a252f582d6cba0d2cc4c48202e22ca010158
1751	0x0000000000000000000000000000000000000000	0x006ad01bcad5e7a7cbf20e69400625d5a2e880a4	478.68	18878425.122735580089325009	3913890	18	0xf17f0b8957ebe0ea263662d0f08adb394ad72edef598d5162c365e3a8fa12e2e
1752	0x0000000000000000000000000000000000000000	0xa0b88734aa32e06ad5af461a3824692446155cf2	957.36	18879382.482735580089325009	3913892	12	0x260b74b9011ea4fc67be832bd7414b05cf13413705931e603752c2b7a340ddf1
1753	0x0000000000000000000000000000000000000000	0x3789873bdcc2d003497a4f56a576b8785b4760f2	95.736	18879478.218735580089325009	3913893	93	0xda317085ee1a5b383f1b2138487ba8f575529bb19fba2110e49ee7eabca8fdf7
1754	0x0000000000000000000000000000000000000000	0xbfa28932b622c476d50d94507ab3e08d4e436975	15.6167100204	18879493.835445600489325009	3913896	11	0xf3362a861550b1dab9ecae145f10cd2a459d3d7713012b727e5efd6007e40926
1755	0x0000000000000000000000000000000000000000	0x2aadfd9dfc66b89c1d7f1bbdf55dd2b85addd1dd	143.604	18879637.439445600489325009	3913899	35	0xcb0e1dd1130efea70f233ae268aaa26fd650b6a9a50bbe0c22aeb2516300b23b
1756	0x0000000000000000000000000000000000000000	0x1cf2a2d22e8ca39ddfcf481039601f5ad74a8e8f	50.74008	18879688.179525600489325009	3913902	32	0xbe2d57b9ac3af075f1fc25a9da9adf5437954c9dde78d61b491b2f1938bde496
1757	0x0000000000000000000000000000000000000000	0xbed8d304be8ee4af8bec6c0316c00ac39486152a	61.74972	18879749.929245600489325009	3913902	36	0xb9b8ffa320e9cfa53e0e0382bf015f91d45b50e0cae641aa209182e643a2cf81
1758	0x0000000000000000000000000000000000000000	0xfb5740c341f174d8570962ac0a61ac7c30728912	191.472	18879941.401245600489325009	3913902	65	0xda610da08288f5ee6a2a014656d687d41526d5026b9b53b42a2baf64cde1e503
1759	0x0000000000000000000000000000000000000000	0x66e91feb8aa69bf00233e7c4800155a508703f23	191.472	18880132.873245600489325009	3913907	4	0xd8fd1f25516dc776e1611bf2f0f154a8cb1acbefa6387ef1528974ad38f5dec4
1760	0x0000000000000000000000000000000000000000	0xe207214e3bc14154f22a59144ccdff6099ca6567	1436.04	18881568.913245600489325009	3913908	26	0x9d33c428d737c0c95ad55b579fee6d76fcdee80e385a828635e7963408ef901e
1761	0x0000000000000000000000000000000000000000	0x85c922bfec970ea8690a4caf1d68d362681ee027	2393.4	18883962.313245600489325009	3913908	29	0x54305fcc79e3c24a50810a1108838c5f1c317d67ea5cfc2f19d110ad1e9c02ba
1762	0x0000000000000000000000000000000000000000	0x180d932fbd59c12c180087085cdcdfa50f20c7db	239.34	18884201.653245600489325009	3913910	13	0x3b28aef400efb8adc380e06fa9be1a8c6dc7d27d77503e5be4d676eee2a9595f
1763	0x0000000000000000000000000000000000000000	0x02977d0d12dadf73d2cb1e40d2512db604c27aa7	1436.04	18885637.693245600489325009	3913910	49	0xc889c7b23a9eb14bb450e5ebea32b7a96c1240892c42042eba021ce602fa922d
1764	0x0000000000000000000000000000000000000000	0xf50da0002bd84a4344074a5026b11203002fc9c7	957.36	18886595.053245600489325009	3913913	52	0x4dfcfb2db2fa499fbd5e2903083213db48de034940d9e89e6bd175a995cc280e
1765	0x0000000000000000000000000000000000000000	0x33e1ab6aabc886dcfb7b58c78dd30a8ee2b75270	478.68	18887073.733245600489325009	3913918	13	0x7f8b15ae9f6473e27f288c7cd61d0e36cf4330f65c588305dfe2832b6e1a3f04
1766	0x0000000000000000000000000000000000000000	0x0072b1dd662d8a5494905654b24f2caeddfe20ef	71.802	18887145.535245600489325009	3913918	17	0x16eb65f039f0812c8417883eb4070fd55a4ef19e9ea89ad8b6c83c2365d688c6
1767	0x0000000000000000000000000000000000000000	0x5113c12e12427747e73b87b76bc524124acb69d2	2393.4	18889538.935245600489325009	3913920	60	0xb9f0b76ade6073b5e82a5ecfa0c44bffa03ff276dd1b19f63753e2f4c275c710
1768	0x0000000000000000000000000000000000000000	0x65ebbabd01496166ed1f71f1756eb061b5564413	191.472	18889730.407245600489325009	3913924	30	0x322351a2b9f494bc67975a8aac6d1a2bcd94c13132cd460a2ff0cbf1f887ec9d
1769	0x0000000000000000000000000000000000000000	0x503bdbd8bc421c32a443032deb2e3e4cd5ba8b4e	47.868	18889778.275245600489325009	3913925	57	0xf76d282aba0c894d9c821a3bcef95d9afb7847d057c933a9e8270c816d881f98
1770	0x0000000000000000000000000000000000000000	0xaff3964ed84db336a5cf8518c804ba7e014e05b7	7180.2	18896958.475245600489325009	3913935	5	0x72881f5f8331f6e9d6dc03a1abd94afe139dc851a2c7626fad86ff0c94627b3c
1771	0x0000000000000000000000000000000000000000	0x691f076c4856ff869a9638ef8ce7f6b1871113a2	1436.04	18898394.515245600489325009	3913945	0	0x360121ea8775f2d235e50ed1e7817bfa1743b6aceb9973f0a3d5696178c4af08
1772	0x0000000000000000000000000000000000000000	0xfdfbe3b93939fad07ad6b5fedfce9359e119c7de	122.1581116248	18898516.673357225289325009	3913946	1	0x04ac9977acf32597a434ef0f683ba4ac3ff848cc87af706c1039e87df9715850
1773	0x0000000000000000000000000000000000000000	0x3a947e267817c7d1888c7d533f1db550d2bbcc41	1914.72	18900431.393357225289325009	3913947	15	0x88920d412ddae2a2fd6539ce2cea1b4a3b5cd0dc625380859aeb735b2c3e798a
1774	0x0000000000000000000000000000000000000000	0x770b2ba3d40896ad9eda2864d9c1ceac1ad74587	2393.4	18902824.793357225289325009	3913948	4	0xf3e98194ac57e4166223ae6941e988c376ad3c305bf05bfe463f2106ec553e06
1775	0x0000000000000000000000000000000000000000	0xfb7cb15da0d388af07619c4abb22988a01eb7ce2	1148.832	18903973.625357225289325009	3913954	11	0x5b6c70404fd350c369889e6355b44984fc7320088d29c52bbbd1b96dcee44eb1
1776	0x0000000000000000000000000000000000000000	0x49e7c0f9fd172d58d2899aa215da1d055def166c	957.36	18904930.985357225289325009	3913954	17	0x891f6160da67a68f12b3ff28789b7b43b38edb5df654f4da980de9e54dcd6c07
1777	0x0000000000000000000000000000000000000000	0x10be3c10c30356ccc69ec85ce72358f8e5efc284	2393.4	18907324.385357225289325009	3913958	9	0x725d70fd640636fde7b6f068190bdd845f2a9664c4e0302c62b2f015baf48d36
1778	0x0000000000000000000000000000000000000000	0x00ee4bb0469826e73febbed98b31012be5c53636	239.34	18907563.725357225289325009	3913961	38	0x46c182f11e86865bc444960aa2c96e42ef209ea71ca8533602f78aeab3f6641b
1779	0x0000000000000000000000000000000000000000	0x8af844e13cd6166251291d1efe1192df45da003c	47.868	18907611.593357225289325009	3913961	68	0xdf59436e0e715a93bc35d7152844fc5ea5f9b4967f6bf27f5da32f19a861f929
1780	0x0000000000000000000000000000000000000000	0xa1e0497554625cdc8277f76b81436a81638174a7	114.8832	18907726.476557225289325009	3913965	35	0xbae8f9b28cfe9521f81df63aa314afcf34984afd7f510afa72978bb0b0af7743
1781	0x0000000000000000000000000000000000000000	0xf50da0002bd84a4344074a5026b11203002fc9c7	957.36	18908683.836557225289325009	3913966	67	0x9bd6b3f9c461a39ed493880fabd259619ad6423060d136a33cb631ca38cb2ba5
1782	0x0000000000000000000000000000000000000000	0x7aa64c6efdc1d4cf57ef0f795dbfdf7d08592b8e	335.076	18909018.912557225289325009	3913969	2	0x26c13dffa80e0418e4eb2957b65caa0c2ca4ac9c02de3766f1232a1c188bad0a
1783	0x0000000000000000000000000000000000000000	0x3960a01c1272e910c792efb0687785b89df5ddb9	7180.2	18916199.112557225289325009	3913978	25	0x8fcded0355c845446bc177213e894807d7a42c013617c71039cc6e67b712d102
1784	0x0000000000000000000000000000000000000000	0x74d09aa08f370035d07ce8eeac5d294af18a81b1	526.548	18916725.660557225289325009	3913978	43	0xebb1cee150b4ba831536be3949479acc301bdbecd91c1761d3b7f1aaf2b2dbd8
1785	0x0000000000000000000000000000000000000000	0xb1cf4fdea18b99fce068ca8316b87d425102c656	233.96538096	18916959.625938185289325009	3913980	45	0xda398ae9f0af93490d12ea6ad47922e0b3b4fc516d5c58b66dc63792f5beb0b7
1786	0x0000000000000000000000000000000000000000	0x6dc49786e800fbac32415e637b4ef74b2de8ef1f	454.746	18917414.371938185289325009	3913984	21	0x07c14c709930a3eb8fd8dd88388e0ea3cef3d63faecf4effff27cf35fcc60a11
1787	0x0000000000000000000000000000000000000000	0x04b005406d8610fb741ac8a73cc6388ff42407bf	148.3908	18917562.762738185289325009	3913984	39	0xa11fc85e63254e4e664074791dbb7ad922dc367b195c0a351e20fe65ca3a24e2
1788	0x0000000000000000000000000000000000000000	0xc9672eaa67112eeb83b7f1b4d8e94cbcc968ff76	119.67	18917682.432738185289325009	3913992	30	0xb40bc358cebaafc9259dd8600ef0159b032a6d1f1bbdd78373edcbb0f25727d5
1789	0x0000000000000000000000000000000000000000	0x92d6315866cb81a2e4da8b44858443a6e8cbb301	5026.14	18922708.572738185289325009	3914000	28	0x0b7bb2a1dfa60b95fd7ef613e2613c6eb7cff380a8c6fe5ccd3a8adee1cb5c8b
1790	0x0000000000000000000000000000000000000000	0xc5e48370a36e69d700e2e8250ba290213f3b3f8f	78.407784	18922786.980522185289325009	3914000	54	0xa8a3e430d1eeaf20643b892badd3e7269a07fbf3cf16cec1170ccad1c3c994dd
1791	0x0000000000000000000000000000000000000000	0x269a0f65ee3bc64b0c6be4aa126b731a75581307	957.36	18923744.340522185289325009	3914010	48	0xe132382188574a6cb18b26b569359dbd8e799f9dc311e3672b976ca88d3cad10
1792	0x0000000000000000000000000000000000000000	0xc648d91c56e05d40d6ff618b7ee2032be6a48b8f	14360.4	18938104.740522185289325009	3914012	0	0xc994bbec5e640605bfa1371c179db73c7fa93882f900c41bfbac9e06a3b660a9
1793	0x0000000000000000000000000000000000000000	0xfc6996480d7eb198540b834161c0c730273001f3	2393.4	18940498.140522185289325009	3914012	25	0x14e0a0faaf5645e09891b10e18f7f2da48f86500e6ae52948f91c8dad9d73399
1794	0x0000000000000000000000000000000000000000	0x282c1cfb4f29324c7e4d0a3bb89a28ddfeddfd45	22.97664	18940521.117162185289325009	3914012	84	0xfeb3e74c85f1f759b366de13672ecf420fc6c411a44caa98638ad006962bf639
1795	0x0000000000000000000000000000000000000000	0x2a6a547a39814086b54623bfa538c21a8811c788	229.7664	18940750.883562185289325009	3914014	63	0x2ae04a528fab76504613336bb25cba1c36c510cb6fa625e3b1d6390b1355474e
1796	0x0000000000000000000000000000000000000000	0x234980ec63009a686645749da99c68cd2bb4f91c	5744.16	18946495.043562185289325009	3914016	1	0x9e3e44285c6acc9321ae39218f6436ee3e2270dcf8b8ac020b73c5655d7ab986
1797	0x0000000000000000000000000000000000000000	0x7e5905c2d6075663115720ef4209f7f832d30969	47.868	18946542.911562185289325009	3914018	0	0x06bf95de932e52bcc7a0b877277be7dc7483e8a00e9973adb5e410454ba1c1d6
1798	0x0000000000000000000000000000000000000000	0x15dbb6a4bf87ee1a103211e33dae36b56ae365fb	21.5406	18946564.452162185289325009	3914018	2	0x3b6378eb2ed6556fde10a90fb948b5b75ae97821b2dc9d10c05e34b09f532dfd
1799	0x0000000000000000000000000000000000000000	0x7f590778907844fe0b6778ed3af581f793d3b7dc	947.7864	18947512.238562185289325009	3914020	35	0x41518e25a95f4bc5fb7c0a542e81ffbeb75b302ee0c2757d5d2d7fccdc6f46fb
1800	0x0000000000000000000000000000000000000000	0xbd9fe35c7b8ef50c18f3c05fa88545770c674372	268.0608	18947780.299362185289325009	3914024	4	0xd5cd03b1f782043eb3dcaffe919d477bb8e01ab9538794977f7d9d2bc3a3b3c5
1801	0x0000000000000000000000000000000000000000	0x5dd5b1bea49c063535be441727454b6589f2003a	119.67	18947899.969362185289325009	3914026	14	0x67133752d180f53980e3d2e4d466bff936bbc16e799515746b09a230cae4c290
1802	0x0000000000000000000000000000000000000000	0x9eb5ed5f6b170eacc7458096481e0d02fc573bc6	1675.38	18949575.349362185289325009	3914027	61	0x7c7906d0f36f37c86defb8f8dbba6831c2190fea4a92be960bd64b2631942c02
1803	0x0000000000000000000000000000000000000000	0xdee3a5ec85ee49d8b926dcd0b35c72d2bb857a73	478.68	18950054.029362185289325009	3914027	65	0xa7aba53f4e290bc78b25edb37c47f12cef6183af5d210b69912e4fa998339777
1804	0x0000000000000000000000000000000000000000	0x858f8750f53b11ed9ce63e9e14b1d1fdfe6740e7	478.68	18950532.709362185289325009	3914030	11	0x0961907eb9f9cc9bde66ed56e599c17953a1839f999edd5c5848e60ed461756a
1805	0x0000000000000000000000000000000000000000	0xbd99a1ea615c5043985d2f4ae59da4459f14e7d2	478.68	18951011.389362185289325009	3914030	17	0x4f23a2f6c7de4ec087b768dbc082eab77a748135821d3a0d7008f97e181fbd55
1806	0x0000000000000000000000000000000000000000	0x3a848a0c9b3979ab9b1e54e5c67b2e540c29fc3c	478.68	18951490.069362185289325009	3914033	10	0x72531406ce1094e393c0fef06e0a80e904a0ce0303ec324f3b1bde9a7fbcbb19
1807	0x0000000000000000000000000000000000000000	0xcab49c828db37b7d0d82551c3436c5f6cf25363d	1627.512	18953117.581362185289325009	3914033	41	0x8152cb83140d0bf16b1147e98e947af2a37ee013a1b7a0ab39f88c5de448a30a
1808	0x0000000000000000000000000000000000000000	0xeed2e8332158d67631e8e4e03ecbbc3e09bdc400	1999.99999985196	18955117.581362037249325009	3914033	44	0xd8fca8bd7cbb3ccea9bb275567e3fd3288a830840de2878a47137c0044a8f2db
1809	0x0000000000000000000000000000000000000000	0xd78f01770a0947f3183b25fd67c59cc71d4c51c9	5265.48	18960383.061362037249325009	3914036	7	0x72afc7bff09d418ef07dbf1cfc9194b62eafbd6ead9e1f9c6310253c1f85895b
1810	0x0000000000000000000000000000000000000000	0xb6221e0827697c2beb143014a2e33a69e7bec152	287.208	18960670.269362037249325009	3914036	8	0xb9a9bfcc15f8f63db3954801491b75b6cd5f33862da5a2da6e18df3a95846e61
1811	0x0000000000000000000000000000000000000000	0x7daa27af51e104d69e8be249e2489f535150f302	957.36	18961627.629362037249325009	3914036	21	0xd5817816f09b150d667061fe701200d9140ee4bd440fc2169fee90b4757d9eb7
1812	0x0000000000000000000000000000000000000000	0xdee3a5ec85ee49d8b926dcd0b35c72d2bb857a73	478.68	18962106.309362037249325009	3914042	13	0xa420af5ce9c2e3d858d443fae7b49d4055dfbad8b9e86c7e1977d88256fdc800
1813	0x0000000000000000000000000000000000000000	0xfcb76dd77f8a3f6861b3c6e75e7e4836c4ab8dea	4815.35536723464	18966921.664729271889325009	3914044	37	0xd6f4c61ca166f9c180797641d26bf5a528624aa0119ad32329e6a2c24d48354f
1814	0x0000000000000000000000000000000000000000	0x15dbb6a4bf87ee1a103211e33dae36b56ae365fb	0	18966921.664729271889325009	3914046	49	0x0768bf4830f32da8fefd294ffa5082f38cc3bb60fc7e642497675c61f4734ce8
1815	0x0000000000000000000000000000000000000000	0xd64ab1334e26ba1bdaf495c7f921c9bd92442650	957.36	18967879.024729271889325009	3914046	68	0x76b05b225996665f7f566a910cf996043b62836839977ceb1f87a1a0b13f76de
1816	0x0000000000000000000000000000000000000000	0x5077da020bbbb1789c9d74602af781983e019932	880.209819476694978111	18968759.23454874858430312	3914048	1	0x061bb6bb3ee3aa8235e8a57e1da00f91a1fd4054c7b8c96c6c5193be09568829
1817	0x0000000000000000000000000000000000000000	0xdced53d5880e5571d3d98e21099001b5c3ab90bf	2393.4	18971152.63454874858430312	3914048	5	0xb451935bc6733b16bee07838b802371d8f155963c396379aa889dbea9cdbc03f
1818	0x0000000000000000000000000000000000000000	0x10e8751f54c51f789d3298737d2feba87954c777	957.36	18972109.99454874858430312	3914049	15	0x06b6a7a43164ba55648bf9003ac9d48fc2711fe1079efa6ca2fac668421e9784
1819	0x0000000000000000000000000000000000000000	0xa9ec9601ed55e2d20087ce09845cfd46c09dc4a2	11967	18984076.99454874858430312	3914054	2	0x0a6f5b27af49dc9b0f1876e393a7c2e7eb5d5a475d3ac77198cbbb8aee85814a
1820	0x0000000000000000000000000000000000000000	0x64133cc0a7cc3d6da61a098af35be9016f174314	143.604	18984220.59854874858430312	3914055	61	0xf640f0a823b71492951b3f0dc8d8d828f6654b4b9a09bbfb9e6c166eebef4c90
1821	0x0000000000000000000000000000000000000000	0xa145f31657d5a92c41338fd628339feb8e385219	47.868	18984268.46654874858430312	3914055	68	0xe19e951c3b04e932e7af5aa6e7bed41753835c1d9fb7f4a93fcb0776ad716555
1822	0x0000000000000000000000000000000000000000	0xb47c80f006817c512a9eac525e1ace042cff1750	17.23248	18984285.69902874858430312	3914056	11	0x8d80dd0562229444c529174c839044b5e24c7fa9b45b8f3a6b564d9ab69ffea8
1823	0x0000000000000000000000000000000000000000	0x5461300a681c98936f54ca0db681720f6a445a5f	1436.04	18985721.73902874858430312	3914057	5	0x64b56b32757034b13a093becdffd5508ca8dfa55ad4ac2706546699e6beafbcd
1824	0x0000000000000000000000000000000000000000	0x36d47ca0af0b9b7b542827f3f30fa5c4b5944ab3	234.5532	18985956.29222874858430312	3914058	54	0x8f94e2a73e5fc5854ea6bac0263f91fd0d942faf4348a2e5be67846e48c191f2
1825	0x0000000000000000000000000000000000000000	0xf3c58d6730bdaa9a722eca0d6489c571af45b75a	14360.4	19000316.69222874858430312	3914061	4	0x031a880a4af25a7d56dcee4d799960736fbe34dc1d22bdbe53d7692253c62f53
1826	0x0000000000000000000000000000000000000000	0x01c0e0c4e761f8fb67893ac27258a627b7481ad7	2441.268	19002757.96022874858430312	3914061	49	0xe4470b4cce34c6f564a6aa1deab276682f6df9abac9fa134238adbaf6f92040b
1827	0x0000000000000000000000000000000000000000	0x47260348ba90c56c9c058d3c42db471cd585ca7b	1914.72	19004672.68022874858430312	3914063	12	0x9772b7268e7914c73cba9ec5ed599ee499527e7e243ac4c8f5d41e59a45c8aa2
1828	0x0000000000000000000000000000000000000000	0xafc6cf06c2ddcdd93bb35f09f3969a566f0e7923	242.21208	19004914.89230874858430312	3914064	0	0x3fb4ddecf6e232d18a2e4b065fc3e9baf744a5f43fdf3605e692ae2f89edae1b
1829	0x0000000000000000000000000000000000000000	0xd43f9b7207a74833632fa52a84be9627e3febf7c	478.68	19005393.57230874858430312	3914064	36	0x4376a9cab6206e07cd4673b361f638b41dd2406671ad0835c7060d3e1c8ee4dc
1830	0x0000000000000000000000000000000000000000	0xb0ab5c4ef6512d7d975314c80aabe7dd19411525	1436.04	19006829.61230874858430312	3914065	10	0xe38f22e33851d838fe1488fd0f1af61fb53219a5b407fd09bc283f75787919a1
1831	0x0000000000000000000000000000000000000000	0x8644cc281be332ccced36da483fb2a0746d9ba2e	478.68	19007308.29230874858430312	3914066	31	0xda373e11e08aa2f464479eb4f37fb1315cb6b5727f576e41b5ec03ff0a34f8b5
1832	0x0000000000000000000000000000000000000000	0xc18a98ddf6188da4a260afd15f805f4f465aeed8	2872.08	19010180.37230874858430312	3914069	22	0x07ad4475248d704b6d5fafee66484d500d3b86b84a2f5ab5ef70647c25a61da4
1833	0x0000000000000000000000000000000000000000	0x267651a42ddd8f6e1cb8f6c04905f071e3652c0a	239.34	19010419.71230874858430312	3914071	7	0x8fb59ea6784b98cb9192f75e56d8f8c86c7bab51bf98331604ed03cd79c92fe8
1834	0x0000000000000000000000000000000000000000	0xb300ea13e72ba6400b8fee073482a70090a5a8e5	0.71802	19010420.43032874858430312	3914071	44	0xffcdad79fb280e9243b8d793d99df1a1a6459870c49950fecf5351f4781a698a
1835	0x0000000000000000000000000000000000000000	0x50573401e2d2b40de7e3dff2f999336fecd480da	957.36	19011377.79032874858430312	3914081	30	0x854070c767d62a8fc2b861c1abe4098191b81dadf939594ca91e774aab20183e
1836	0x0000000000000000000000000000000000000000	0x79b476347b1f99062d8be0d2af8f697f503ebf64	521.7612	19011899.55152874858430312	3914085	17	0xad30a5a1a394dff40d74d5ebde43b6d5d69263147ddf85bfde2168f26b7d410b
1837	0x0000000000000000000000000000000000000000	0xe6440a4014e05066c48d694c8e09dbdcbfcf259c	2391.0066	19014290.55812874858430312	3914090	2	0xf5ce97c22edcc7cc7ccc9348ada9cd09b37c83366eba7b6bb3e294ac02e283ba
1838	0x0000000000000000000000000000000000000000	0x179899d02c6c1c06a422969a3a7e4f5e266f7381	67.0152	19014357.57332874858430312	3914093	43	0xf571bc0e49d77be25a189cb4097272603faf865dc0af52798c29b743308eb670
1839	0x0000000000000000000000000000000000000000	0xd6c1590b5be28453ae7f04247600f2ae697bc58a	3350.76	19017708.33332874858430312	3914101	8	0x9b61ceffb6e9694a536717faeda1d98c22015e7bb59e52d5a3412919bca2447d
1840	0x0000000000000000000000000000000000000000	0x095c014039a014a6974eaaa3fa01d43150d343f8	14360.4	19032068.73332874858430312	3914101	30	0xbf4c9e298147d885c32ab2ad695a3b6ddc3ac0152d6fcbf71d9c16199f26bc24
1841	0x0000000000000000000000000000000000000000	0x8118d2f274ca941fee1c0b378c13c53de080c3a7	143.604	19032212.33732874858430312	3914101	40	0x8eea58b8352f9c46001794e845872a31edf419484bf0491e67c43c1a2dc4fdf8
1842	0x0000000000000000000000000000000000000000	0x357f4347d6e8712816bbfc1ba5db8cd289ddca22	3829.44	19036041.77732874858430312	3914102	0	0xdf074ba8cb99f95c66fe992d27866d09b2c6c6de2537d487d35b89c935cf7e2e
1843	0x0000000000000000000000000000000000000000	0xfe90d41f282e3ea872c5fa2eeaf8738ac172b444	99.999985704	19036141.77731445258430312	3914102	48	0x51f65f264edab0e06b0787a350cff2e207f4df7a743f82b22e195e7d12b28714
1844	0x0000000000000000000000000000000000000000	0x4e7936d45924393bce6fe20d0f5b9c339dad0a7f	4786.8	19040928.57731445258430312	3914105	1	0x1b8f5d8a073af27a6bd927fffabe9eab387ba1243b8099e443a74cb8719463f9
1845	0x0000000000000000000000000000000000000000	0x2b913c14d9e12d72bbace0d28885aaf9c3181d4c	505.4749219692	19041434.05223642178430312	3914106	13	0xee5c5973b2f3325d94f4887e1da8f6955f77a447ff15db00327349e8396e0705
1846	0x0000000000000000000000000000000000000000	0x5e4ec67d1c6b7cf9ce4d976604ab5ddef953bc34	478.68	19041912.73223642178430312	3914107	15	0xef6e2f4db57809fd96768a3ec7993a4d8cd800eaae60b030a2fcdf2c83c653a4
1847	0x0000000000000000000000000000000000000000	0xb7cf65db50ab0494c0c9c6aab5835b70df6c21d9	45.010388103	19041957.74262452478430312	3914110	77	0xc00bcfb487f49e3a87288d2848f5c3d584b988ce5d6c38b6227ba0291ff6b609
1848	0x0000000000000000000000000000000000000000	0xb510fb4523d4e795792797ba66456af7c1defceb	478.68	19042436.42262452478430312	3914114	13	0xbf35049e93e5565d02e679dd81f3c75fea54e58bd29c303bd6c137a3827b26e2
1849	0x0000000000000000000000000000000000000000	0x2d70df345ee1328610beef589490782238e1fbf8	957.36	19043393.78262452478430312	3914130	8	0x8d88db6f5c77f4cca961f43234fd03c758802558eb16da4406a20b8ce9861af8
1850	0x0000000000000000000000000000000000000000	0xa3b08b54130007c370b30c3f967c2d35e3dd640b	478.68	19043872.46262452478430312	3914131	16	0x865fb9be0b96c5238ce7bcb988035553271316a153279a8bc9dcc4ce45cbdc71
1851	0x0000000000000000000000000000000000000000	0xfd38837e33beb3067d3fab6e7a9fe46c7475efff	957.36	19044829.82262452478430312	3914135	30	0xcaa46c04030887812bc1e83dae10533016c055eac633338ecd574633246c54e0
1852	0x0000000000000000000000000000000000000000	0xb36a9525d266a2c49bfb26130c0da2fce49252f9	2393.4	19047223.22262452478430312	3914140	2	0x44d6e837ff4395508c26070343a112b36613f00448303ce5b7c85b09c35a6ac1
1853	0x0000000000000000000000000000000000000000	0x7fe01ff0adaf111a94ad0d69ed27cde23553af44	957.36	19048180.58262452478430312	3914148	30	0x662414a10e36c7445cdb1ff667a1c14104c732ea4a966eaeaa8224112161a4bc
1854	0x0000000000000000000000000000000000000000	0x14a926e168278cc0c00286837de51e29f814b8d3	1914.72	19050095.30262452478430312	3914149	32	0x6374e96fa8d7bbefba3df5f0f21d6ca9c16c10774e535c47f5f701c590af9f76
1855	0x0000000000000000000000000000000000000000	0xa0220e4c0683cd7658cd78e66459d05eb02b041c	957.36	19051052.66262452478430312	3914154	12	0x358adbebbc08c25fbeeef3d53247f52b8f58de10e62bc9b3687ad465960bcb5e
1856	0x0000000000000000000000000000000000000000	0xce735a5c6feb88dd7d13b5faa7c27894eb4e5ae0	5217.612	19056270.27462452478430312	3914154	15	0xff1ab936a4606175a40862cf28897922599b289bdbe9c8ccc120b0ba884dcdbc
1857	0x0000000000000000000000000000000000000000	0x41471c54ad062d5bef945c0cacbe2661d04b7d18	478.68	19056748.95462452478430312	3914156	89	0xf6f1dc14fcbebce03329a0d7f05ea20cdc0bb7c54ea34c80ff6413ddca4e4c73
1858	0x0000000000000000000000000000000000000000	0x503bdbd8bc421c32a443032deb2e3e4cd5ba8b4e	478.68	19057227.63462452478430312	3914157	72	0x2eb4b7bf776ca68ff744f4241864b336295bc56128d5ccde0c324102b5909dea
1859	0x0000000000000000000000000000000000000000	0xd43f9b7207a74833632fa52a84be9627e3febf7c	2393.4	19059621.03462452478430312	3914158	37	0xab78a11b84ae2da777bb7548d807c992a354d1cc0b3363b45e790a958b181fe4
1860	0x0000000000000000000000000000000000000000	0x4ae2862a8ea225a7d08aacdbbc1ff37056e94375	478.68	19060099.71462452478430312	3914159	3	0xe1eb26ddef72c9b8d5d5b89bee2b06f95e684ed147bc2d8a495aebb0882ca967
1861	0x0000000000000000000000000000000000000000	0x56d18aef3ff077826dd50c68cef9ddc84a6827ee	163.5220973862	19060263.23672191098430312	3914162	5	0x53e1a83e36f5e5d3eaff75870901ca382f832fbba102ccb8f4764ba215f28c05
1862	0x0000000000000000000000000000000000000000	0x751205a1fa7e15270505c11efff575e6b74627a2	23934	19084197.23672191098430312	3914162	24	0x19dce4c2d46e997917ac90820d90d95287869ea4d2f63dc491cfda35fe14d815
1863	0x0000000000000000000000000000000000000000	0xa145f31657d5a92c41338fd628339feb8e385219	1340.304	19085537.54072191098430312	3914165	58	0x7dd16e13355b500cbbb65b4d1ed3890a6292a10125008121f08563f33eb8e3f0
1864	0x0000000000000000000000000000000000000000	0xce9fab16ac5030a2709f88ffef3da2d3fbfc9268	957.36	19086494.90072191098430312	3914169	14	0x645f140b52b8563c4178ba4b02a87a9ae3dcaaf61d596f60e4381e587398efca
1865	0x0000000000000000000000000000000000000000	0xd4bb0e903a36ae9428cc146744fd8c76a2388170	478.68	19086973.58072191098430312	3914177	7	0xa38434535be35007002adf46c753be02a96e5bba0dd6f3c234d9c086ae1b3f37
1866	0x0000000000000000000000000000000000000000	0xc206f372c131189810f83a0643a71b530a994790	1005.228	19087978.80872191098430312	3914178	55	0xb279a56bd5025abc598d7996a96bff62d4dd277771ffff153ec9f67fa86fbbf8
1867	0x0000000000000000000000000000000000000000	0x75978297078063832cc06c2a9f38b0967b1428b8	1436.04	19089414.84872191098430312	3914181	20	0x98b237144dacbdf0557c4027125b1a0588dd69b7e64e6808cfb63e5997d2b4ee
1868	0x0000000000000000000000000000000000000000	0xe9051118284832065f51952ea3b7bf6aa5eaf470	478.68	19089893.52872191098430312	3914182	17	0x4fb367d65fd99a44dbecd4d9f06329df45db23407d6757afe809cacee48884ee
1869	0x0000000000000000000000000000000000000000	0x4d811394afbd306204633fceb6364f4a0a05cd87	38294.4	19128187.92872191098430312	3914184	43	0xb81cd132f4f969fdbf41d2ffaf2988da7476a638640255b86d1ca1b0aa926b57
1870	0x0000000000000000000000000000000000000000	0x817b28702c530f6ed3ca2e442de822660daf83ae	478.68	19128666.60872191098430312	3914185	18	0xa0353baacf9b38531dea12de029c380b211a5bf5b88730315bcbb732eeb06160
1871	0x0000000000000000000000000000000000000000	0x189b40bb46b5b260d8ebafa9043aa7382d8238d9	119.67	19128786.27872191098430312	3914187	20	0x6577d9fca4307205833ca964d8672999bb2eb503d9da0380fb8aa84a3cce67ec
1872	0x0000000000000000000000000000000000000000	0x7fcccd2cda09d48fc6775f802b535ed504d721dd	2393.4	19131179.67872191098430312	3914220	8	0x64d6062ca633544895f49c8e6c7c87640bd0f22dc1f0d1dbb91fb07f84e2294b
1873	0x0000000000000000000000000000000000000000	0x179899d02c6c1c06a422969a3a7e4f5e266f7381	732.3804	19131912.05912191098430312	3914224	146	0xf58b489471d3de08ffaca55010e08279f4cb72aac75dc1f3ceda5e4d4d25b802
1874	0x0000000000000000000000000000000000000000	0x9b2e4c482e0525d44df2663291a11b1af021346c	718.02	19132630.07912191098430312	3914225	138	0x18b97bb0dd2c5200317d47e3339f8cb6ce936fff31a757d326dae476ea64185e
1875	0x0000000000000000000000000000000000000000	0x14d3760771ef679c77026466d60b1277e3c7cd34	49.999992852	19132680.07911476298430312	3914230	5	0x617d22d1af7629df0a479c18b503d25f57a0f7aa68a1ef0d94a0e8785f6b032e
1876	0x0000000000000000000000000000000000000000	0xa6775db75b0998c25c10f3edebaa50ad0145c37d	5744.16	19138424.23911476298430312	3914230	15	0x390dfd0cd003ae405c25680937e338f6658696260cb990c07d65c85639c0ac87
1877	0x0000000000000000000000000000000000000000	0x60ba4fd243d26dbed15dd90416a64be601ba3f93	1053.096	19139477.33511476298430312	3914237	2	0xb23408d961af22456470a185b3eb0d2d319e79cb685b11f2e2f299f34187e369
1878	0x0000000000000000000000000000000000000000	0xbbd2e65afd28e73cab552ad55b972a016f98dfa4	2393.4	19141870.73511476298430312	3914239	110	0x08f81be7230a23c3ec7bd59920a93439f8afb58170718f2740ff86fc88876243
1879	0x0000000000000000000000000000000000000000	0x18e6fad1c6f2dd9f5911e95a67373eb433d7a60b	2872.08	19144742.81511476298430312	3914243	39	0x6a2df6232e4617074538647d1953c7f94731f69dc5be1774acd23be228c6e466
1880	0x0000000000000000000000000000000000000000	0x607b404467091c3f7cd41773f636ca9a15756798	506.26305327144	19145249.07816803442430312	3914243	51	0x894c8e832795f9f89acd3c8e7ed6b56a4ce2de0b1e0c33e4ad3c94744895b23e
1881	0x0000000000000000000000000000000000000000	0x007d2f4fe301922c560d1a752836c4e99e0ed63c	2441.268	19147690.34616803442430312	3914245	51	0xb61c6ef1a7d755ca6b65f3c1ab9468f494e9abd6947c3063faaea1a615987f6c
1882	0x0000000000000000000000000000000000000000	0x8298e3d7a1fc53b402383eb539706ac0de9598fb	47.868	19147738.21416803442430312	3914245	81	0x9aca127d463c9db3562c2dd21872aaa94efc3c48689b26c8e1f7e29a5a207918
1883	0x0000000000000000000000000000000000000000	0x3b2b67ac0f6d518cbbd950ae43711ff8621db230	4786.8	19152525.01416803442430312	3914245	85	0xaf10ae41fe18113420e499d8e06437d4ddf25038cdc4a8006d66dd56f79f508e
1884	0x0000000000000000000000000000000000000000	0xbfa28932b622c476d50d94507ab3e08d4e436975	86.199832776	19152611.21400081042430312	3914247	4	0xb2d15be9ba7a5e50d41bc879b9ad483252242f651605ce3a191d2732b937a40f
1885	0x0000000000000000000000000000000000000000	0xe8024972b4594a5155cc59c6d45f13a90193c7ff	2297.664	19154908.87800081042430312	3914247	49	0xe7299c1712b1a789ca754e4ee866430b793da851ecd7f8660d243e675c52f441
1886	0x0000000000000000000000000000000000000000	0xc045d5cc0b65d0799a8283b08b33f457e7fa6e0a	110.0964	19155018.97440081042430312	3914253	18	0x73e1abe2db6d21b9b477e286dc22106379f7982582d868bf82ad1435a3ebe6b0
1887	0x0000000000000000000000000000000000000000	0x7db59859ee343ea9c6567bfab86a6b1f872c4811	71.802	19155090.77640081042430312	3914258	133	0xa5cd81482e4b5354c516502e75b478321b00a782f34cb4f74dcb5fbd795972be
1888	0x0000000000000000000000000000000000000000	0xbbd2e65afd28e73cab552ad55b972a016f98dfa4	2632.74	19157723.51640081042430312	3914258	134	0xece42ea13dcc0951ab792266c362b54eb9fd4555f9eb46d5c6dc2b47e0d8e696
1889	0x0000000000000000000000000000000000000000	0xc801244c5f39711400dc52e99cbe7ae5ccc0e23e	1436.04	19159159.55640081042430312	3914263	2	0x250ab4e7c101c06749db2fa469c15cc4a353bd88505bd5646f2232bd6b52dd3e
1890	0x0000000000000000000000000000000000000000	0x367da11915185d9bbe33b319d7b87356eaed0fd7	718.02	19159877.57640081042430312	3914270	5	0x6aec430b1b59561d9cfd5018103e42b7c76d64d5a3ffb301f1c67712f03053bc
1891	0x0000000000000000000000000000000000000000	0x14d3760771ef679c77026466d60b1277e3c7cd34	50.000007164532	19159927.57640797495630312	3914272	40	0x0ae1a3223d4894f9e28f68bd41470894b84c8c64c05f493cafead0e610aba003
1892	0x0000000000000000000000000000000000000000	0x648c499296be9984873190ef47af2336d921c10d	7180.2	19167107.77640797495630312	3914273	59	0xb8c0766d8d94662e9b699f046f0144696ee7f349773a25d74b4fcb1b1cfb1102
1893	0x0000000000000000000000000000000000000000	0x2fb7206c0c2d2fa10bb9880f9ff42177117713cc	215.406	19167323.18240797495630312	3914277	21	0x7d957df8e13da811e1a1f30279ab71112ea74259df9d3e7f3f55b460ff0f5386
1894	0x0000000000000000000000000000000000000000	0xef20b133ef2fa536695c19ae7516d573eee5b8c7	478.68	19167801.86240797495630312	3914283	9	0x49878020f7c5eb3b81af7eb766c69ebe1c4a02db148b751513a7d3fa2643318c
1895	0x0000000000000000000000000000000000000000	0x14b3d1b85484fd1ffca319d3538bc2f1a4e15983	47.868	19167849.73040797495630312	3914283	14	0x0c204f98402fdb71b2ae9fa39cf749a18b7bfa091442fb96d10466e51db8abda
1896	0x0000000000000000000000000000000000000000	0xa1a15e2a84ce58df73a04c4e6d4f813c389de316	4786.8	19172636.53040797495630312	3914286	41	0x881e864473534bbd4b72863acd9baf33769d8c5bef4dc5675353da9650f84d7c
1897	0x0000000000000000000000000000000000000000	0x9ac0233a97b0005462f7d65943b8cf6d7d074280	14.3604	19172650.89080797495630312	3914286	44	0xa699e3c45bc42cafc0846fe76d5df5834011b055059cff865dd356c250e0bff8
1898	0x0000000000000000000000000000000000000000	0x46c18eee191d5c5153da38b25d1c47d35a9e690f	62228.4	19234879.29080797495630312	3914288	4	0x17121b874f5f25b549e67b338175288b41eca0545dc8887a41ae7e1e6f78702b
1899	0x0000000000000000000000000000000000000000	0x734f9849b317236a8687422ddc1286b77d1f9870	478.68	19235357.97080797495630312	3914291	8	0x246ecf2656b1148f7802db3057bfd2dd9a68da9d3c73e8f931344b606f340510
1900	0x0000000000000000000000000000000000000000	0x66966658f42abeb9ded0e4023a596166923bb665	2831.7578588652	19238189.72866684015630312	3914291	50	0x465958adea74dda6873463640c4683791b7abff53314296c508a55778e1b5b9f
1901	0x0000000000000000000000000000000000000000	0xf3b31d0eab3337ffbd440c4e8c5581f37478ef00	31.1142	19238220.84286684015630312	3914300	115	0x2a940f5e1d65df8563808efe8730073ccd12ed6ae8ef159622c2ab5e08b55298
1902	0x0000000000000000000000000000000000000000	0x734f9849b317236a8687422ddc1286b77d1f9870	478.68	19238699.52286684015630312	3914302	10	0x3a342f97ab83d89d80c9a4de4475f7e7201c6417fc46f88d3f3329a50f51aacb
1903	0x0000000000000000000000000000000000000000	0x14b3d1b85484fd1ffca319d3538bc2f1a4e15983	47.868	19238747.39086684015630312	3914304	0	0x3c10691cd44218abb59265bd1a2ce72e597c0833223118a21c6b7432fa798a6b
1904	0x0000000000000000000000000000000000000000	0xe776d2e55d085b80579547f7ecd13fb9bdf8e9ab	90.9492	19238838.34006684015630312	3914314	34	0x340002bdfc87831e2d28515a7c6c1cbd3910ba3087998392b0177e36a7550d55
1905	0x0000000000000000000000000000000000000000	0x611c99ff8133ac6de639af71cf6acf2d01ce4eaf	5.792028	19238844.13209484015630312	3914314	59	0x5bc7f7b8ebdfa092ca86c6255f2152da45462b6e9c4f22a553644815aea67e55
1906	0x0000000000000000000000000000000000000000	0x6ff9ad7a1ff442d97f0c1a286ee2356b2844e3f6	8137.56	19246981.69209484015630312	3914316	76	0xf98798ab211a159463e71463dbde7a1a4c918d1d6c35b05ee7420543ace78bb3
1907	0x0000000000000000000000000000000000000000	0x1269680a3f96ecdba5167153a57e823b7b53ce39	95.736	19247077.42809484015630312	3914319	2	0x0dd0839701e53c2978abf924c0e00aca90f2278be1931d5dd0e27f3abaeeefb2
1908	0x0000000000000000000000000000000000000000	0x14b3d1b85484fd1ffca319d3538bc2f1a4e15983	382.944	19247460.37209484015630312	3914319	12	0xee1e9649ad2c6153c2accc2878de4822a7bc6acf9d2ab737f64bd1e2fa7df8d0
1909	0x0000000000000000000000000000000000000000	0xad3473c2ad652e7404224b1381cb90da47049ec1	7180.2	19254640.57209484015630312	3914319	115	0x62f65dbd8ce8583bb30e1e4545557d718dadd4c38c56b8b8fdf296364079d6e5
1910	0x0000000000000000000000000000000000000000	0x64096ada06b161686a19066f619c02c39433d971	1436.04	19256076.61209484015630312	3914324	37	0xcd59f614373f5212b8283e1d92a3f1c54fa7c4b9a3ccff2a45f58110d84b293d
1911	0x0000000000000000000000000000000000000000	0x64096ada06b161686a19066f619c02c39433d971	1436.04	19257512.65209484015630312	3914328	85	0xeff11fe03847f1688523fb0196cbcc9c6c0654c3e112bdda57e891867abdf607
1912	0x0000000000000000000000000000000000000000	0xb36a9525d266a2c49bfb26130c0da2fce49252f9	1436.04	19258948.69209484015630312	3914330	3	0x47659e5550555ea371fb0d4d8050a23de283cd9885e0799ddbf339d356277bbf
1913	0x0000000000000000000000000000000000000000	0x344b4e61acc56f87f0ee1fec9763172cec8b7fd9	20396.5548	19279345.24689484015630312	3914330	4	0xe3b6e05edd84786fb861047d123bccfbc65510a741787f1a7b004629031cc06b
1914	0x0000000000000000000000000000000000000000	0x14b3d1b85484fd1ffca319d3538bc2f1a4e15983	4308.12	19283653.36689484015630312	3914331	0	0x7ce1f9fce54e80ea5f40b61276f4095ed267822861798a64be0db07fca603931
1915	0x0000000000000000000000000000000000000000	0x4b86b29dde908223087bc50df6b493a083fb218c	1962.588	19285615.95489484015630312	3914331	36	0x3a2cbe9962cf1d3b63dd2ac8bee016faefe0e3aaa7a0607d46a478618cbad4b3
1916	0x0000000000000000000000000000000000000000	0x67436a2c32f8e72e9de5bcf1b5f6fff8172d4ad2	478.68	19286094.63489484015630312	3914332	59	0x3cf85cb38af402d0b81cc99ff96081284cf373fae9db88893929fe0c89716baf
1917	0x0000000000000000000000000000000000000000	0x3b22dfd362dfbe26589766da2bd9696da8ffd8b9	750.043692	19286844.67858684015630312	3914343	1	0x39bf0167e50fb693a69e3502ec280738f4edf087118ff7d80a12e7ccdcf2335a
1918	0x0000000000000000000000000000000000000000	0x6b6044128855a568687263b78693629a4c900559	47868	19334712.67858684015630312	3914343	2	0x712ddced919e5e6dfd2a15d98065e4914e56516778705df8d1ac437ff1f314fb
1919	0x0000000000000000000000000000000000000000	0x14b3d1b85484fd1ffca319d3538bc2f1a4e15983	9573.6	19344286.27858684015630312	3914345	0	0x43c2498abba88ca70d94cf3328ea739156c18a6c9aab20582cc25de9c0833a25
1920	0x0000000000000000000000000000000000000000	0x00e6c476935f406432d33d2c3e9710518bbedbb2	1436.04	19345722.31858684015630312	3914352	144	0x3bc6f006d21caa20090664fb805195207936dfcf805e0cfd799b15012eca6ca3
1921	0x0000000000000000000000000000000000000000	0x5a15ca21251712af8fb6908ea73158787e24c3a1	1436.04	19347158.35858684015630312	3914352	157	0x00048d59757676815dbb4c4b10f64ac2c92e089ab9c0a714243ce52c3ec2e06b
1922	0x0000000000000000000000000000000000000000	0xa449ade2de8b5a6c1b56e96a3bfbbb7a4a73799f	1443.2202	19348601.57878684015630312	3914356	7	0x88641a2244495a798ac50c4ec8b607756e13ac88008096d01df7e90603d9f7ed
1923	0x0000000000000000000000000000000000000000	0x937cb55f801c945b4c3c5246662e3b5f2bb50058	598.35	19349199.92878684015630312	3914357	120	0x4838871602e5f5010941ae8d90f4ca627079b1214d3abc42cbaea1a391fbc322
1924	0x0000000000000000000000000000000000000000	0xb9a7c3840323d2383f70e4980730cbe57a82ca53	957.36	19350157.28878684015630312	3914361	6	0xd4112b57339c9e1e3154040ec9db2c089e28938bd3ecbcdd73654d8f5b4fec0e
1925	0x0000000000000000000000000000000000000000	0x5a077eebfc4127e59ae4e61b45d7bb28558aa256	478.68	19350635.96878684015630312	3914363	3	0x2aaf7bc49c24c59fe13460dbdbfdb5270083dc7af48e8d508904bbf3c9d7197d
1926	0x0000000000000000000000000000000000000000	0xcf9bb70b2f1accb846e8b0c665a1ab5d5d35ca05	399.6978	19351035.66658684015630312	3914364	2	0x364859edaab26d087f9a5b243d52c6d1e6925bc5ef1314a5c19157eefa83fdd7
1927	0x0000000000000000000000000000000000000000	0xbd23fd37baa4e569b9a97bbb93cc5ec6573cec7e	1914.72	19352950.38658684015630312	3914364	54	0x3cc669853f37ac867f052991da52cc8d80768a4491ae536caf92e833b0661a3e
1928	0x0000000000000000000000000000000000000000	0x865a6450f5abd0267fd7c7eb4fdf29ac04dd31e2	33.5076	19352983.89418684015630312	3914365	33	0x217c1d473d8e8c2954730c0a737efcd4d3a3952017e302280f83c0b2580b8284
1929	0x0000000000000000000000000000000000000000	0x503bdbd8bc421c32a443032deb2e3e4cd5ba8b4e	478.68	19353462.57418684015630312	3914365	34	0x82b50d79b68b3602f736b9bbb109debdb87a153ec5409250d1cbfb0af9433d4a
1930	0x0000000000000000000000000000000000000000	0xdfb826225aec7a3a7435dbe2da63b648707e0ae8	957.36	19354419.93418684015630312	3914370	22	0xe41a6c9bac24c9030aaafb10b2ed9b92c5d1cb25a0e239dd606c03ca952f3164
1931	0x0000000000000000000000000000000000000000	0xb68b73ebe644473aa0a66381905856238aff1c6f	1436.04	19355855.97418684015630312	3914370	42	0xde771205be60c22a2d2f98ae9348a07f043da55d253506b0abdb1f75af4b8703
1932	0x0000000000000000000000000000000000000000	0x7c5605aeb6338c16507f3bb271040232ef958c93	119.67	19355975.64418684015630312	3914381	16	0x2653f2886451af4fab0e106531760d70181ce7ebc38e0e0d070dc8e805d68557
1933	0x0000000000000000000000000000000000000000	0xbdece842f9814f450998f87ab612febbe7d44ed4	47.868	19356023.51218684015630312	3914387	0	0x3f90271d6a18dbe438f701c95a08b05032adf0dacaae91d30338a792b19102ae
1934	0x0000000000000000000000000000000000000000	0x7960a3bb4101a698f4cd035c2e827aa14df19150	1914.72	19357938.23218684015630312	3914391	18	0x2a2e82aa6e775f1e31681f7822eb111b57f05b14fc4d6cb67d50826d53171861
1935	0x0000000000000000000000000000000000000000	0x37e337c6b7d5269a3f15c2af779fb3586510627d	4786.8	19362725.03218684015630312	3914396	15	0x3d81098523c55afca1d68d822298daea3c69d8620fa3f62ad0a24858812b4071
1936	0x0000000000000000000000000000000000000000	0x3b536143d6a933f8b9ce05aca58c04d81e5d87b1	3350.76	19366075.79218684015630312	3914396	30	0xac5c254ae0c3f0018813f3fde2cb6ff79abd1b6addc007c116624a350cec662a
1937	0x0000000000000000000000000000000000000000	0x8644cc281be332ccced36da483fb2a0746d9ba2e	957.36	19367033.15218684015630312	3914397	61	0xdd88a8cd7dedf05a68b7592ec32d3e8363fd8c27bd5ea0ee1acb9ff46ec4d47c
1938	0x0000000000000000000000000000000000000000	0xdf4df1c92e6b54e1d4bcb58c62a16da554537843	881.4561144912	19367914.60830133135630312	3914398	16	0x91e0a05b59e5d6cf79cd940dc2e660d7d8c7b0f634dcda96890f98dbf53f8951
1939	0x0000000000000000000000000000000000000000	0xe862b94b5801ecede9698dc132bd49e76b39fd63	239.34	19368153.94830133135630312	3914408	10	0x28110e654a6b461e051b7c0e517832477aa88dd0ddfb6fb8b4613748e94ed79d
1940	0x0000000000000000000000000000000000000000	0x46fae5ba9ab12084aabb5ea3416e30343ec16ff4	430.812	19368584.76030133135630312	3914409	50	0x05a1e82c10471c61e001dcec5884f37d6a7c9220a55168d29b5e13b852e31527
1941	0x0000000000000000000000000000000000000000	0x00f4ab45d439ea057802f9b540aee548304e657f	632.04065680512132	19369216.80095813647762312	3914412	3	0x4752cb062cae04072b0bc7f4bf8e21c4116e4a31571c00ab67392cef3f8899bf
1942	0x0000000000000000000000000000000000000000	0x2a8e3cc1ecf384046c4d8fddd5c2d4956f579f71	11967	19381183.80095813647762312	3914413	51	0x5597cbe84ca73cd271ec75be83d68cd660de926b9cba0896ea5045927e5af32c
1943	0x0000000000000000000000000000000000000000	0x9a3d6b710c1f85cb4f44ddb40871d987233b8728	957.36	19382141.16095813647762312	3914433	115	0xd19671e939e49a98dca65b5a1090dcf91d958687db94e6ffd92ffdd65547454a
1944	0x0000000000000000000000000000000000000000	0xbc44ba87f406fcfd4300e252715d713297b01c1d	47.868	19382189.02895813647762312	3914434	0	0xecc15dc7532cb403e20f4cfdfe64171b16e388d28b5a9c9e0a3b2dda348a0803
1945	0x0000000000000000000000000000000000000000	0xf108a33a0c124577f5612a069ea9153952a0de1b	201.0456	19382390.07455813647762312	3914437	2	0xbad5962307c1db35e32b6277ef81ac51bb3d804e9dafd5ad484c1981756e67ce
1946	0x0000000000000000000000000000000000000000	0xcb3ca157ccd432e5f1c4ebe2999318541aec9190	19147.2	19401537.27455813647762312	3914446	1	0x06a79e90f45917d6eeadd25ab7b9ca1738f512d6c412dd8a41221a6bb20cf818
1947	0x0000000000000000000000000000000000000000	0x9b5bc5c65d5b5fc2f6de2109cf85f3cd5f130d0a	143.604	19401680.87855813647762312	3914464	7	0x09f4f387b9f6ff502b1567c4307f9ec4b0c54bbacd98845c9c1d5869fe4ab982
1948	0x0000000000000000000000000000000000000000	0xcad089c2b25db33dab552e0323b6495123e45808	2154.06	19403834.93855813647762312	3914465	21	0xe89d2d72ea96433546f449f96bd20bc7d409022fd62b7b80bc8676d341805e5c
1949	0x0000000000000000000000000000000000000000	0x126a0027d9484fbf19e749409f743edff092b52a	478.68	19404313.61855813647762312	3914465	91	0x3f8dc0ad0ab906e4a77055626e8e9cfa883935d05026f97aeb0aaadf5affbd6c
1950	0x0000000000000000000000000000000000000000	0xb5bb2f301b0175202595b87d1c9700f2e24684a6	2393.4	19406707.01855813647762312	3914472	60	0x11c92c13f5c3d57bf0ee8458ef94b29cedbfd9aec93c91457d8edd14b402068c
1951	0x0000000000000000000000000000000000000000	0x8d0cde4f252c6c3959c41cf0ac04a51abf86564a	1063.62696	19407770.64551813647762312	3914472	67	0x46f48581dfe3e19c95df9f44db2a8b308cd37d3e6c6ee8295a054106eabdb357
1952	0x0000000000000000000000000000000000000000	0xca9c951e9e182bec3edac76be054a816e765fc9a	957.36	19408728.00551813647762312	3914479	46	0xc26a00bf3add1e901f0d112edf76026f36fbcb12c190c6e4701ae257ed9ceafb
1953	0x0000000000000000000000000000000000000000	0x4b86b29dde908223087bc50df6b493a083fb218c	1967.3904241152	19410695.39594225167762312	3914485	20	0x967adc4695423585de39ee314c0e6536d9fc2399054e1b2cc8e7405c32431de1
1954	0x0000000000000000000000000000000000000000	0xd7fb7fe1bc62ce4d2f5f9342853df76a5761d63c	1914.72	19412610.11594225167762312	3914487	8	0x69e41c67a78fea54c39ee986f6927ae1135eeeb762c4f82bed3cb0c7e8be1875
1955	0x0000000000000000000000000000000000000000	0xc5f894686c49e3e94a60fcbb685e8ba3fa1b935f	119.67	19412729.78594225167762312	3914487	10	0x853d57eaa26658abbceaee784e5b2ca0eb9a71488af66eaacc79d9f20030761e
1956	0x0000000000000000000000000000000000000000	0xd5209ebeb328456c37fa62b51fd73e8db19e3344	569.0260632	19413298.81200545167762312	3914489	8	0xb37429ae510032618bee1033187fd144897ac5bd0718de07f018273ca023ef5b
1957	0x0000000000000000000000000000000000000000	0x46889390d104e4a079f79ee6118cf007d8f39ae4	74.71056929772	19413373.52257474939762312	3914502	18	0x849a08b5262b68b618d3d288877e8c55e645f72107350e8023a8e9189f04b31d
1958	0x0000000000000000000000000000000000000000	0xddfa88193650887dd0b3257509fb268d5d5a5430	23.934	19413397.45657474939762312	3914503	14	0x5034a3edc80250fa7b31d5e4ede7d849d82bfaaab4a257a93e2444ea8c7da063
1959	0x0000000000000000000000000000000000000000	0x9bd5546effa701a52787b9e7ea532792d2d8137a	3829.44	19417226.89657474939762312	3914504	96	0x5939641bdc2bf00b2375121366c19841c2151c5b7a8b001b21cc67ab42494dbc
1960	0x0000000000000000000000000000000000000000	0x7fe74b7700e82ece262a5dcace18ec0eb826d49a	476.50846818	19417703.40504292939762312	3914513	4	0x4ce50f159275008ed05250e8adc71ca0f1e8a899aa9a9bfe50db0fd1ec1d7a65
1961	0x0000000000000000000000000000000000000000	0x5a077eebfc4127e59ae4e61b45d7bb28558aa256	957.36	19418660.76504292939762312	3914515	32	0x9030030c67ca06844289a844f1a1a199416765dc6f0c1e92e0536fc29339c17e
1962	0x0000000000000000000000000000000000000000	0x5d18ad2973f61ef670365cf2b5855253e8d6c53f	478.68	19419139.44504292939762312	3914525	0	0x36fd05f5b44cb71e6b9d6539e6984412cd1bd2817607a2245e27ce073282a465
1963	0x0000000000000000000000000000000000000000	0xd0cde965c22da3eb9b5f7379df05b5d0a3e2f3be	9.5736	19419149.01864292939762312	3914527	3	0xddb1197cf8d7573a633f5a8902bedd75a9d06cb0c2fe469e1ef88a707df0b03f
1964	0x0000000000000000000000000000000000000000	0x331e4277ee9ffb2f1c2710b978b846b940eeb6ce	478.68	19419627.69864292939762312	3914527	73	0xaf9b4414533e830a291d0a1f074e43aa811cbf4647fad4544ed7483e106b0e85
1965	0x0000000000000000000000000000000000000000	0xd0cde965c22da3eb9b5f7379df05b5d0a3e2f3be	1062.6696	19420690.36824292939762312	3914531	30	0x6e33b1a762421813a8f3cb65008635b2fb3f55d6793709799709859d76cdf8a3
1966	0x0000000000000000000000000000000000000000	0x0e8f318136b24201c62a8bd510d07c33b0af7e6d	1148.832	19421839.20024292939762312	3914532	21	0x62e1bf744bcbf87bc1504a6c6f0bcc7e0c5d1f006bf3b6a229ee38122458b095
1967	0x0000000000000000000000000000000000000000	0x00b6b8044e91c7223abb8a675e7a1a6ab02419ce	718.02	19422557.22024292939762312	3914534	49	0xe5e755e7b75d7ade6ef7f08b2ecbd376981ba1bfa817db1c9c8c6eb0b65e974d
1968	0x0000000000000000000000000000000000000000	0x69f82cf1ff36a87f98967a40366cb5730a862e90	957.36	19423514.58024292939762312	3914545	4	0x0c0286caa0ff018246cac870edb32f76bf4948ff0f933292feb8602e8fda3173
1969	0x0000000000000000000000000000000000000000	0xa2279a574c9b7fcb1aab61b314b94257919b6fde	718.02	19424232.60024292939762312	3914548	15	0x13fcd58fda0baa99efbf135c6687a068085ef2cfec2b58bd819046327586969f
1970	0x0000000000000000000000000000000000000000	0xd416b8241fc88cbc6c5a4abceb3a4136baacfa93	1000.000000644	19425232.60024357339762312	3914551	43	0x5414657006e19f096067d4544c5f316f39f414596b3e934f66d0fa9a6113716e
1971	0x0000000000000000000000000000000000000000	0xaff3964ed84db336a5cf8518c804ba7e014e05b7	7180.2	19432412.80024357339762312	3914553	29	0x733d79f3d75e746af72efdfadb0f9684e502f580ec3507de504c399b24e8718d
1972	0x0000000000000000000000000000000000000000	0x62d1a192056b18649a73e332d099d5917ffea16b	143.604	19432556.40424357339762312	3914559	28	0xb884cbb0db752df1b50a20cb6057eceb12a8b0ab9201812bbb7f80b58548672f
1973	0x0000000000000000000000000000000000000000	0xa4998fa51d035389abc367b702855121db5051a6	957.36	19433513.76424357339762312	3914561	19	0x3db6a720e18704cb1833735d2cf6d81492ce12eeb5d01722fb9824fc1f754abf
1974	0x0000000000000000000000000000000000000000	0xfe8b6ccbffd86dd79e3ecc23bafa11b142c99415	2393.4	19435907.16424357339762312	3914561	20	0xb388d944e2b446fcf5606ff08a3691aa700c5308b6c5d3dbd0714efeed1c6698
1975	0x0000000000000000000000000000000000000000	0xb209c5ad937a8475c1ae6252a443e1b0f891e3ac	7180.2	19443087.36424357339762312	3914561	26	0x2d0323863d9bc000e427ca24025b77474b7a3bca2a6bc28422a3cc51e06474d7
1976	0x0000000000000000000000000000000000000000	0xb8a1bae86d19e93f8827b05995c4823cb68af634	478.68	19443566.04424357339762312	3914562	1	0x8997752132ac46ffc70b098b17de8ed249b882d2794974a9b6f8e5eee0f80659
1977	0x0000000000000000000000000000000000000000	0x67e7e452a8671efecb9284c483de75c3ff1f02a9	14.6117357208	19443580.65597929419762312	3914562	87	0x4e5f596dfd028d8e984f2e754753020fbbed971de4d8854dbed1fdb09aa2ab5e
1978	0x0000000000000000000000000000000000000000	0xe4b01b2d5f7b3a670986b78ed5b03361a35365c9	12.331490886	19443592.98747018019762312	3914563	11	0x27411b1a71594fa8f662f86c0de5f69d9f83dd626b4d82498590154a73db74ed
1979	0x0000000000000000000000000000000000000000	0x71ca3f6e9e6680c73f912ac2c3921c7833a59e92	478.68	19444071.66747018019762312	3914563	18	0x162f4aa4ae5988261d3403711698316f7b68bd915532ce97c013f68cde60c558
1980	0x0000000000000000000000000000000000000000	0x8e7bd3dc5a41971455a7e5af99c3ab77766b964e	47.868	19444119.53547018019762312	3914570	42	0x6f98170eae09a4bfba148e49732dadbad70859b087abd929d791bb721d878a9f
1981	0x0000000000000000000000000000000000000000	0xc303f011539270cf79895b485f396f59bfa6f69a	253.317456	19444372.85292618019762312	3914570	43	0xd98d4c4b847e5e4a93c3235742fd19460cc47fe06dfb1eb789e379e4ae99f0bd
1982	0x0000000000000000000000000000000000000000	0x4845347ce1b144a3fe0b7a1a8e1dd991a77d04b9	2383.8264	19446756.67932618019762312	3914573	0	0xb67ff5f50f132dc33a7ca6fe864500bf1b47bda56ba61b3c8c87df748d3a107a
1983	0x0000000000000000000000000000000000000000	0x9724e26ef240d244cd44a022f68ea1be7c2f5d0e	2393.4	19449150.07932618019762312	3914573	37	0x66ee368fe1579a74e57d31baa90f06b744936930f843d0e91973140178da4cd1
1984	0x0000000000000000000000000000000000000000	0x60b1f440ee5127ddb040e590ec86c41c5c643c0a	239.34	19449389.41932618019762312	3914573	41	0x7c353c32a55809b68218e824e68ff5f9853a6d5ac6dcff106498e231ad588023
1985	0x0000000000000000000000000000000000000000	0x25e15c9b5789ad0f1a8e17bde38caeed1e8fe0eb	478.68	19449868.09932618019762312	3914573	44	0xcc56a9df2457a19c497bee4f05cc6fb062f5124ea9a711817d4b96b8717d7486
1986	0x0000000000000000000000000000000000000000	0x3826bb3543b0c0f22df68e379b4a306e18bdf3b6	478.68	19450346.77932618019762312	3914576	2	0x4c5876b1e56236a66300fe309b0597e6f840a4eeca0013274e8e4d5afc37137a
1987	0x0000000000000000000000000000000000000000	0x80a2b1499a6c7091093c56d8a3e75a8982add35d	2393.4	19452740.17932618019762312	3914576	7	0x3d52f67034198fce8045549ce554b4b3a51a5db34151d635569c37dcf034d9ed
1988	0x0000000000000000000000000000000000000000	0x3dc768eb0a77c54215f37206401df32d9028d974	1436.04	19454176.21932618019762312	3914577	0	0x1f3d685e2b2b6faf38d8475e649fcecba108ca10ffce4d9aae4ac66f350c3a08
1989	0x0000000000000000000000000000000000000000	0x675131a228a69279e1bd2cde488996dcacf06c83	147.1927573026	19454323.41208348279762312	3914584	74	0xd2d56710ae84c3d9594a336e3e4831067718cdf750f365bb8d48baf4dee87ba7
1990	0x0000000000000000000000000000000000000000	0x376ebfc4dd85d9bf1c1a30c390e4697de36b53e8	117.670601508	19454441.08268499079762312	3914588	24	0xa81fe6d642fd9af2e448bb16a64e5da36d4b3fc8ffdc5a9971a29cd8e644b030
1991	0x0000000000000000000000000000000000000000	0xee7f765ceb55df8cbfc0a405ffc61bc8766edf79	1914.72	19456355.80268499079762312	3914588	88	0x5ba63b04a1f23733c29a4c80fe2da8e04031f74ba3ea107decdac56098ac16ba
1992	0x0000000000000000000000000000000000000000	0x6072e771aa1ff91e45fcd9e41574dd9d58ac49bc	1005.228	19457361.03068499079762312	3914591	29	0x378ade93da22962e0c4cc045fe84252f5210f65097420ae90dfce6584f5ef6cc
1993	0x0000000000000000000000000000000000000000	0xab96bc9e9f5be7443c25f90c8c174a26fe10dfb7	95.736	19457456.76668499079762312	3914599	1	0x996bdd4489cffd231afd74dab8ccce5f3fa6f500782831562925a9caad658b5a
1994	0x0000000000000000000000000000000000000000	0xcfe3af99290736c40a9e4be6a1353ba62486ed5b	196.52639360832	19457653.29307859911762312	3914600	36	0x6952bb130e76e2bb5ba8fbd244199a5e75a4c6d730ac932152bd24d23e1395f4
1995	0x0000000000000000000000000000000000000000	0x12955bee7e9c5d1cbdcd6078d263e994c9cc48da	142.16796	19457795.46103859911762312	3914607	65	0xd72e25a61a81629cd96526912e405f891f44b7c8ab8f39d0fb9843e26e67948f
1996	0x0000000000000000000000000000000000000000	0x7dd37a118c41c1f92b50c3d82822375e5dd7c660	1436.04	19459231.50103859911762312	3914609	26	0x2bb78137ef7be0cf44f058f008fbf3c5704a7dc906ccd4e0476a1709a9c59df4
1997	0x0000000000000000000000000000000000000000	0xcd12160164555bbf29c899bffb88514ee457d658	1675.38	19460906.88103859911762312	3914609	31	0xe32fe6a06bd681122b57f5d369323e9b5ce4e74442da3f90f534a03ba03c7509
1998	0x0000000000000000000000000000000000000000	0xafc6cf06c2ddcdd93bb35f09f3969a566f0e7923	955.660686	19461862.54172459911762312	3914609	35	0x7fe79deaa6e65ed6813021003bef8496d84e678f6a848a7419d4dbeaf068c7e0
1999	0x0000000000000000000000000000000000000000	0x9a50c025b84f503474f148c9cfa6913f64304147	2632.74	19464495.28172459911762312	3914633	23	0x256ec038cb355228d787ad7c6263e7c6a4df4cf55470ab4753ffc55acaaaebf0
2000	0x0000000000000000000000000000000000000000	0xe11dd7b89b89bb04a1aaca233355c57eb8a1788a	139.530056515784825404	19464634.811781114902448524	3914641	19	0x88f372be0935c4f02336d31723b786aa52c2caddfbe099e371b2f3901de5a50d
2001	0x0000000000000000000000000000000000000000	0x6972dccb3adfdb19babcf546e369941547210963	4786.8	19469421.611781114902448524	3914641	20	0x889108d8d52b84555d46d53744a8fd0362e2e66dcb99fe7ca037effc19c0eb45
2002	0x0000000000000000000000000000000000000000	0xe15ac1a2355a779aa5ab299a6708b2dd0fceb8bf	718.02	19470139.631781114902448524	3914646	111	0xd63e73b63df6c158dce3fe979f2cddcf7a1bfb98cd7622b9c30b82d3cbb92cf6
2003	0x0000000000000000000000000000000000000000	0x15cf81d52ed94f2b5658bbb6c911fca5bac7aefc	1914.72	19472054.351781114902448524	3914648	64	0xca173d66c2d2dd2439c34c7cd8fa3ed4dea1f17a1ae1b21a4699d485156d9a81
2004	0x0000000000000000000000000000000000000000	0x88d053d544f0e1d49046be70eda64d2a6166b0f3	731.135832	19472785.487613114902448524	3914653	40	0x80b1c6b58649d70b57280c2a3ab8c3d6ade4ad17f05d2891ab1c58e3bb7410ad
2005	0x0000000000000000000000000000000000000000	0xe5ae51871f3b58e4be4c29783d7ff8571473f488	5942.13410957088	19478727.621722685782448524	3914658	0	0xaea300e432ee8147bb657b20f725bae5b7dccc7203bc7a0a83dabf8123f6c5a4
2006	0x0000000000000000000000000000000000000000	0xd5ea0f5db78429faafbfd2c3b6154ef02bf90658	335.7478249866	19479063.369547672382448524	3914663	34	0x3f0019dcbfa603607942aa289b3c2ec696865210cbc70139536794f98628c066
2007	0x0000000000000000000000000000000000000000	0x641744e7f741e108b772a350f80f05ac49a5c08a	469.1064	19479532.475947672382448524	3914674	98	0x53eb69ec3417bd412d0f9440973e18cb498d986cbbc0c10931580ba128d99a0e
2008	0x0000000000000000000000000000000000000000	0xfb6aa5928fbc204f6e7c9c6f725e063501b7dcdf	143.604	19479676.079947672382448524	3914677	54	0xfdef0d46686bf0914a6375b282eb48bf09f85ab469ee6405b44b6eabe926aafa
2009	0x0000000000000000000000000000000000000000	0x5a2026fb3f58d7071bcca942f3803113f5590c5d	3350.76	19483026.839947672382448524	3914678	5	0x1bc11ada6bdd28e517ceff7c00ca329c5214201180afe685fbde7484ca2c61c9
2010	0x0000000000000000000000000000000000000000	0x97122926f1bd8644be5d8800b2505028ab282234	1196.7	19484223.539947672382448524	3914682	18	0x1a013e1d97a83afc28f1c7cde07d4b2fae8665f2fcab474f1165750391a5e327
2011	0x0000000000000000000000000000000000000000	0x6e2afc5147cd8e46119cf20f5b7df0915c1b69f4	478.68	19484702.219947672382448524	3914682	41	0x345dd39e2b9a3ad55c129daba264ca820389c7005cd0a7afa053fa5898d69dd1
2012	0x0000000000000000000000000000000000000000	0x3d2cb0e757f432485ca30a1ae56da52479991d86	47.868	19484750.087947672382448524	3914689	50	0x8c606cf128df109f5386bf15341e7a92afb537ae55a66821785e25ae0194cab7
2013	0x0000000000000000000000000000000000000000	0x1ed990bbbaa43212e776194e4f3b6130566f96ed	2431.6944	19487181.782347672382448524	3914692	0	0x30b6e36b084210d37fe8e94c84ba5248013d95723e3642d3af5a0414b16561f3
2014	0x0000000000000000000000000000000000000000	0xb7301419339fb7e63a0a8d181456058825c1ea48	478.68	19487660.462347672382448524	3914695	31	0x562bd2dbf91890e58a72552a3fb13006fa4a10e0134232beda8409f3ef100d40
2015	0x0000000000000000000000000000000000000000	0x1ce8ef94b7a76c1791623640f417df9a66c3e1f1	478.68	19488139.142347672382448524	3914698	30	0x2d20c4226430faf1b02caa9360aea3d06d7720f4a3c9a177ced5050df1ad8b37
2016	0x0000000000000000000000000000000000000000	0x5274a6e18f047582ed3985ca6205311f3d852637	95.736	19488234.878347672382448524	3914705	59	0x0bb1627651571040d77ff86d61e08999aaca50e813939bdd80a4b25f00469673
2017	0x0000000000000000000000000000000000000000	0xb7301419339fb7e63a0a8d181456058825c1ea48	1196.834124771266949144	19489431.712472443649397668	3914705	62	0x39961c37d3ce2225a7aea2449f787023db4ddc03400bb81ddbea641eaa266307
2018	0x0000000000000000000000000000000000000000	0x75c8e2dd57927eb0373e8e201ebf582406adcf45	287208	19776639.712472443649397668	3914706	3	0x9209e385d25e23a6ee8a1d4330317aa48524774bdc7411cd2a9e04c4cb42bbfc
2019	0x0000000000000000000000000000000000000000	0x90bb44ee2e9afebe694874f184eb11a917cbdea6	335.076	19776974.788472443649397668	3914710	0	0x1fd0678aa88492e75365312be2f2de397f29ab6f9d9abc67d92a273d2667028d
2020	0x0000000000000000000000000000000000000000	0x08610407945d93043e749f6f0833d7b8cc7e4afb	1436.04	19778410.828472443649397668	3914719	5	0xa7699660434272788e5e461dc1f380752043cdc3d7c686a01c2408b3fc0a0ad9
2021	0x0000000000000000000000000000000000000000	0x8cf2bef55ea9a7908029853cf6289356f24e332b	90.9492	19778501.777672443649397668	3914730	38	0x59c453399d80d9c224180b895caefaf8705647a9ab3f55e789fcd87e713319e6
2022	0x0000000000000000000000000000000000000000	0x10a95451ac0f2ae698cd1165a79f016ad52ad1d7	95.736	19778597.513672443649397668	3914733	24	0x0ccccad642476e962df56b7bb06e09b7e7c91bad11d78648021231460af7647f
2023	0x0000000000000000000000000000000000000000	0x4a8f54eaf9a674efc302be8c5c1275ea0d7b15f6	478.68	19779076.193672443649397668	3914748	2	0x13560815bd6d348c51a8fa4a0491d5f490dd722ad8909d39d42827fa6abed59a
2024	0x0000000000000000000000000000000000000000	0x10a95451ac0f2ae698cd1165a79f016ad52ad1d7	2154.06	19781230.253672443649397668	3914748	3	0x4b0ce55f1b718361d17cd0d186284d1a422b7fa75a4555252dd3a1681f021827
2025	0x0000000000000000000000000000000000000000	0x64133cc0a7cc3d6da61a098af35be9016f174314	167.538	19781397.791672443649397668	3914751	110	0xd1882f365b0064c4611b65d0be8fbda433b60e09277809cd807c9b23822362ab
2026	0x0000000000000000000000000000000000000000	0x38a8faa204535875634624b8a0dbe66394063c3d	359.01	19781756.801672443649397668	3914753	5	0xe51bb51fee58ac8e7941177531527f80e0dd4093844d51ed8a18ee3f34a84b0b
2027	0x0000000000000000000000000000000000000000	0xf6970e87b5f70296b831bc37f480507158bbb09d	1962.588	19783719.389672443649397668	3914775	73	0x4fdc9531a2cf9333c7f79a37a9f109219d044460811fab880c2a7af33db377a5
2028	0x0000000000000000000000000000000000000000	0x73ac5742843e8033c517a46f4c8157927df173cf	2821.37470759032	19786540.764380033969397668	3914775	82	0x782463cbae50fb3849d0b06165b9b31dad01d40530dd92301024d295f3b1d16c
2029	0x0000000000000000000000000000000000000000	0x611c99ff8133ac6de639af71cf6acf2d01ce4eaf	57.4416	19786598.205980033969397668	3914790	33	0x086d027400a1d4b0cdbc0379ef488e498a31926e5b745eb3630f0711c04e8966
2030	0x0000000000000000000000000000000000000000	0x8d856843d8add1ceffb479dbbf34d8c3b8a8bf6e	1914.72	19788512.925980033969397668	3914792	3	0xdc44a92725a02586a62637bd6d4ff3f2cf528a778a63885f853eb9450305774d
2031	0x0000000000000000000000000000000000000000	0x2cf0ccd4b4bade563af4f02b4f246a936df9e00b	454.746	19788967.671980033969397668	3914795	66	0xfe531f05603eb8223bfbe43198582586624e869fdcd3dbeb1cdf9234a6017a03
2032	0x0000000000000000000000000000000000000000	0xe90847ac4522bab98d45ab2f976d2c199aaedc96	4308.12	19793275.791980033969397668	3914803	6	0x5cb515cb5f65dfc74694ad0d387c3123ebeeb5aa91bcc5550e519ca806b70565
2033	0x0000000000000000000000000000000000000000	0xed03ae92f64aad82506bc1be4ed764ff2589ad37	110.0964	19793385.888380033969397668	3914816	10	0x205da8d5cd1a24a585e9ed71eb65510cdb96e2e4477c77b90724023f117cc049
2034	0x0000000000000000000000000000000000000000	0x7a04930453967d01193c5b23907bb493cd52bddb	1196.7	19794582.588380033969397668	3914821	79	0x84412957bb847c68a6fbeb09b3c9474dacf0cb22bc5ba34dcbf1e5a0dfc073f1
2035	0x0000000000000000000000000000000000000000	0xa022f375a261ed5c25f2842e13562b7e8a42d1fc	143.604	19794726.192380033969397668	3914830	17	0xf41e0a677b9297621fad8e599ce60db425108755dabc42c66a4f261c599fce2f
2036	0x0000000000000000000000000000000000000000	0x8885bd3aacb89868036905974d4fa44bb84d0677	598.35	19795324.542380033969397668	3914838	38	0xffb001b236be9dee2863ecddc6284c76d96a5f958e202a1d353b88422e011cc0
2037	0x0000000000000000000000000000000000000000	0xa6d109f76ba3ea154f3ade4abeae1a58b2829c42	95.736	19795420.278380033969397668	3914855	2	0x51eb7b7fcb67b1c653654d14b7eb42f64e42cf0aa71d0a1ff00a7e5e13c4fd7e
2038	0x0000000000000000000000000000000000000000	0x2dc480240835906c3d52438834a3f7656def7ac2	472.45716	19795892.735540033969397668	3914857	91	0x085740ebe7432ce2d27d31c543f0029a5f2995dfeb5d6b5c9546a2b8e6a5a7ec
2039	0x0000000000000000000000000000000000000000	0xbb8c5fc990982be6f1113b33ec1a1f4ab397b00e	143.604	19796036.339540033969397668	3914862	12	0x9a8b6df50c8bc25bf40af2411e6257251b558f6c0e3039754ff02b2f0fd45ced
2040	0x0000000000000000000000000000000000000000	0x211bf5f756566b45de75242517208513997215c7	3973.044	19800009.383540033969397668	3914865	69	0xd40e16805e9655212e616f21835003be273d1a7b9addad778b304e53a0250d1e
2041	0x0000000000000000000000000000000000000000	0x2c4cb2a9786ebd63cab9869b15817f1bc9e4ea7e	287.208	19800296.591540033969397668	3914872	155	0x235e855010fbd604af3d8b9bb9352c52a04d87807954b201efb37bc0085b3536
2042	0x0000000000000000000000000000000000000000	0x8885bd3aacb89868036905974d4fa44bb84d0677	694.086	19800990.677540033969397668	3914879	89	0x81cd293f86edcd26de0261f13c2b88680e5624363fbdc5ce5baa21ca3862c9f8
2043	0x0000000000000000000000000000000000000000	0x78a1e254409fb1b55a7cb4dd8eba3b30c8bad9ef	718.02	19801708.697540033969397668	3914882	2	0xddc3c77cd249abdc9dfe75320184f454a24f5279a97ea517547fbdb32fbec808
2044	0x0000000000000000000000000000000000000000	0x6deb12971da2291b7a5c0a06f8887246ab777764	478.68	19802187.377540033969397668	3914883	79	0xf5b4d975abac51fc6b5ef86b87d058dafa9b0f363b1c80bf111eb3181bc91b89
2045	0x0000000000000000000000000000000000000000	0x107051c193b331a566992400e6611b9838a5fbb1	143.604	19802330.981540033969397668	3914889	4	0x67979f58429d49b124157017a791316ed430137f37c53e332f3c6e38c7341082
2046	0x0000000000000000000000000000000000000000	0x008bc906e4f9615b55387118be9974b9b391e052	23934	19826264.981540033969397668	3914893	1	0x95c8bfb8858def24f63ffb0763409db527c96556fbd7fc51885814c3fe5df543
2047	0x0000000000000000000000000000000000000000	0x9c38bf872c28ab78c2112e100b93f3ed70ee2acc	516.9744	19826781.955940033969397668	3914900	8	0xa06f39d2ff7e325df0815e4ba37022be2f527487e0e87c5acabcb831ad7128f3
2048	0x0000000000000000000000000000000000000000	0x41538283f0cac4e338db29d96d195d7b8042b186	9.5736	19826791.529540033969397668	3914908	15	0x2e7a458b505eb937970dd0b5a0ba625d2af2c4f66810c5e08f7eaea464c1fc00
2049	0x0000000000000000000000000000000000000000	0x926adfba641fb58d1741fe6ce525d0075886ca5a	3925.176	19830716.705540033969397668	3914908	35	0xeaa9b8608a28014bf9d77622dda5a9fa426ecddd425ab921cbff56dc6a264903
2050	0x0000000000000000000000000000000000000000	0x6ed98129ca2887b8c277369df7e02b945dd6627b	4786.8	19835503.505540033969397668	3914909	9	0x01e64168e9589b7fe3db3319a288b053e9beef791fc1a760bde67a21788e91fd
2051	0x0000000000000000000000000000000000000000	0x9782b9c2c85c2e9db211cb6200065e312853e68c	95.736	19835599.241540033969397668	3914913	12	0x2cd39b63e31bfd314b79285fd5f6651204085f3ff733c77c4805b220fd526aeb
2052	0x0000000000000000000000000000000000000000	0xe3a576e1e3f0d8519b617c01191712d8658ec96a	201.0456	19835800.287140033969397668	3914913	22	0xb2504a64f2f19a6997757eb992703c3389425d2c6e86d8fc1e64e101ae58c6ab
2053	0x0000000000000000000000000000000000000000	0xff1ecf03174a7a0536b1fd84e525764242e718a5	430.812	19836231.099140033969397668	3914916	16	0xe4aa87cfee88fecf8ec79cbd1c547c4a5b165620a2771fcc956778614dd38e14
2054	0x0000000000000000000000000000000000000000	0x71ca3f6e9e6680c73f912ac2c3921c7833a59e92	6701.52	19842932.619140033969397668	3914926	34	0xcf635707a83b69c2b5aa56052594b4aa16ef9c134a111d67448d9f14ec75a84a
2055	0x0000000000000000000000000000000000000000	0x41538283f0cac4e338db29d96d195d7b8042b186	52.6548	19842985.273940033969397668	3914929	59	0x76623091027c924b212a008bcab9d7eefe34175412a84277bc18f39bed8f2b17
2056	0x0000000000000000000000000000000000000000	0x10348e888063870cac8588f24c917d1d5a679631	86.1624	19843071.436340033969397668	3914931	192	0x9db3803ec6d6acb55f246d98257c0d3ecbe9e965a02d1e92dad8d94c2e90ca29
2057	0x0000000000000000000000000000000000000000	0xcd1ae1edbb722b033b119f2b866cdd422ff44962	560.0556	19843631.491940033969397668	3914932	46	0xe5f5cafd5f6f8f9bd499e113026f695d05420f94db223acdb82919894b713719
2058	0x0000000000000000000000000000000000000000	0x31cd91c89a17c7cdc61445c275b8b247b00e9b3b	47.868	19843679.359940033969397668	3914934	70	0x80016cd42db862252c0f867a37987ff8d12216cabe2f6c03b4f0104bba7b027e
2059	0x0000000000000000000000000000000000000000	0xb54180244f5d9c929cd5f07f818d160b03df88be	47.868	19843727.227940033969397668	3914938	69	0xff2ac1f5a20030275da03255494dc8f5c7da921711cb6969e2a15ae277d67424
2060	0x0000000000000000000000000000000000000000	0xc2bd3cd7dc39c03ad9d96a494a6947d619749b62	822.987990018	19844550.215930051969397668	3914943	10	0xf4eebe4ffccf27a049e2667a069b9aef0762d9ae9a58619858f0b50d3f84f3dd
2061	0x0000000000000000000000000000000000000000	0x0a91c561665c0128786016a227db24fc08990011	2393.4	19846943.615930051969397668	3914948	24	0x920b99198b109b3ec03b2ec882585a3070d65e1fb3edb8db2aaec3bcb16833bd
2062	0x0000000000000000000000000000000000000000	0xb54180244f5d9c929cd5f07f818d160b03df88be	1196.7	19848140.315930051969397668	3914948	39	0xe54357aaa2f66f8bd35f831e6ed91b4c81cf33468c86bc532a4567be32bfe9bd
2063	0x0000000000000000000000000000000000000000	0xac6f5d2ff8c3a23ce78186f09248e5852b1ec19c	276.19836	19848416.514290051969397668	3914953	44	0x3a658351acfd76a524c49704f6f48bfed0f6bc4bc583351d23d3e38f881cca36
2064	0x0000000000000000000000000000000000000000	0x435370bbdba56a72e22e276d6c8ef0632f3e2481	9812.94	19858229.454290051969397668	3914961	10	0x516af56f390f5a7c5d4b04236f8a33a9f1b9e9531d10896cbb2c293232423e24
2065	0x0000000000000000000000000000000000000000	0x18984247706f2124419a6128cf4500260e0d44df	957.36	19859186.814290051969397668	3914966	16	0xddf6f4ebe57278040dd80b1e668d29b2c7e81fd433504b7ce9f76280440a732f
2066	0x0000000000000000000000000000000000000000	0x2967c551f7b2ad78f9d18a2d3f6c4341049b422d	478.68	19859665.494290051969397668	3914966	101	0xe5aed5aeb398ce174baf935496f432893646cd990fbca84d1c75b16e4adbed38
2067	0x0000000000000000000000000000000000000000	0x60b3f28ebdc483b627b919d9d61f9f1ae416366c	9.5736	19859675.067890051969397668	3914971	2	0x12cac863df5e596cac2940651d64ffc324d05ea04bcc56ec2cafe35c96806a29
2068	0x0000000000000000000000000000000000000000	0x008bc906e4f9615b55387118be9974b9b391e052	47868	19907543.067890051969397668	3914975	63	0xe3dd03ab998ffe661a32998f39901e0dfc3e7dc6ad5bf8fa0b800527866d96d4
2069	0x0000000000000000000000000000000000000000	0x93750ddf10aee0f883cec77769606a6bf97efe70	718.02	19908261.087890051969397668	3914975	66	0xe65f97b4332b273bb4a9ba2a814b6f34953b36a8e988194b1e247dcbbff91799
2070	0x0000000000000000000000000000000000000000	0x0e5d3090c61145be2e8cf81fe1e636453047dcfd	718.02	19908979.107890051969397668	3914977	95	0xaa0f63563a54ca00bc3368387d91a156671d4dcf98fce32f4da61bc492f10e3a
2071	0x0000000000000000000000000000000000000000	0xa947f442cf5fa41ecd06c768b7ce72135f6369d9	957.36	19909936.467890051969397668	3914980	28	0xd346cfd8b71de80432569d80a8291a35526285d9567d1b7e24a1d55bb0faccb8
2072	0x0000000000000000000000000000000000000000	0x41538283f0cac4e338db29d96d195d7b8042b186	62.2284	19909998.696290051969397668	3914984	30	0x13504902688d731122d3121b8a2e3369cc3504f63593f5bf98cbdd0265bfa895
2073	0x0000000000000000000000000000000000000000	0x21d4d7bb1730097c3e9991ef209ad786689cebbb	16.3974514608	19910015.093741512769397668	3914984	41	0xbda0eecf9f2ad6b2fb67bf94d0c08f2770a6af1520cafb6b397972273e0be771
2074	0x0000000000000000000000000000000000000000	0x05935224eb230cde970e26f02ed36d3248dfa7d1	430.812	19910445.905741512769397668	3915008	5	0xf213c0c8e1beec4b0c75c78ef3c55cf02183b944f37d4461dda7594cc42abe4f
2075	0x0000000000000000000000000000000000000000	0x7f590778907844fe0b6778ed3af581f793d3b7dc	1488.6948	19911934.600541512769397668	3915009	21	0xf6794d768094befba3b259b28e44c43f5fab2f695c12510856053518e9431b22
2076	0x0000000000000000000000000000000000000000	0x4544451c39b3ca161ec5662e12a97aeec4ab753c	1704.1008	19913638.701341512769397668	3915014	29	0x820786dbe90505293c64d8bcef68b59cf155c6c6b22b93ea05fa7a6ce9fe80cc
2077	0x0000000000000000000000000000000000000000	0x866b158c050587a281e82f815135f9191b92048d	114.8832	19913753.584541512769397668	3915019	40	0xd0d6bfbcd8df996db77d9da667ec1ad605aff315edc01b3a8ef4c7bbaa82766e
2078	0x0000000000000000000000000000000000000000	0x905b9dd172662259d725998716d683740ed3a3fc	239.34	19913992.924541512769397668	3915025	3	0x8ec576d126c7d354ba3b52298b4251800cb1f31c924db292a231d79a19f22c0e
2079	0x0000000000000000000000000000000000000000	0x34305d66b00342e4e03598ff30f57cf840a85124	215.406	19914208.330541512769397668	3915025	4	0xc2ea64d2bbd8fd22ed2979c026235edd4d9a7286c5c5a5f73b6fa845625495d6
2080	0x0000000000000000000000000000000000000000	0xb3e0b76d843e5a89d7ff71af5b81fe414d1332af	481.0734	19914689.403941512769397668	3915025	78	0xdca48c513d5413026bb44983eed254a12c947c204323e60190b9f029459a08e5
2081	0x0000000000000000000000000000000000000000	0x60b3f28ebdc483b627b919d9d61f9f1ae416366c	44.19461973228	19914733.598561245049397668	3915025	112	0x9cad74a220fe0a46b535c1d51e742fccd996a4207a4a729ea47118ebd8ec15cd
2082	0x0000000000000000000000000000000000000000	0xcf691536873c396099caefc223cd72d58bfd50d9	27.28476	19914760.883321245049397668	3915036	7	0x02ec61762c401466adc90500ddfbb3054760c36e125ba9f07fa8f9da14d3eb77
2083	0x0000000000000000000000000000000000000000	0x89119acdba3a2242ad395df00e71f7fb1e2ee8dd	239.34	19915000.223321245049397668	3915036	65	0xce89ca81ad1dc5de94d1efa330fcd735887fe0d10073c2416b3766ebecf0c82e
2084	0x0000000000000000000000000000000000000000	0x6104602bdce8d0e9737ca8ba0dcf5e3bb34ea38b	239.34	19915239.563321245049397668	3915036	80	0xd2c02878e73c51902a3997b2ceea9c46cbbd357d11cd2ae4eea1c95904449ff8
2085	0x0000000000000000000000000000000000000000	0x1f3a03a35f490a2c039086c63b3bbeabe6a99ff1	335.076	19915574.639321245049397668	3915042	80	0xb5298e5986d82960f27544b770b7a150641b19d75a6c1d6548631c3cc58c5b6c
2086	0x0000000000000000000000000000000000000000	0x7370c54885703c4003d48b4af8183397ef96a74e	1436.04	19917010.679321245049397668	3915045	2	0x0ae06110ccd49643211c5291ae4f6214781669e91d6ca9aa2c52c90b9b6410b5
2087	0x0000000000000000000000000000000000000000	0x7e68a854e6ad5aa39045c8d6947b9eb6959a3be3	1000.4412	19918011.120521245049397668	3915050	4	0x99ec202607330fc62e5ba47ece78ee96ca3615b60609ac02ed22b0c340cab18d
2088	0x0000000000000000000000000000000000000000	0x2c050cd43fb3e5a5f066f6132ebd41a6d1ef3374	670.152	19918681.272521245049397668	3915052	4	0x99d969622c4c2622c142c24bb5c9d852df525dda8ff29a6ccb2320720afdc6b9
2089	0x0000000000000000000000000000000000000000	0x32f14b5393b465596977e04f2e8d8c8f703ab02e	95.736	19918777.008521245049397668	3915054	101	0x81c9c484146160bbccf3e7750ade3eeec230fe0411bf739aa92b819b48b56407
2090	0x0000000000000000000000000000000000000000	0x3e2ee1b447815a295be9966b8387fb59299214db	1818.984	19920595.992521245049397668	3915062	37	0xcb4445e4646b23b61e6bd26704dd695e2613100982382c51b5f3b28b64ce5ab3
2091	0x0000000000000000000000000000000000000000	0x2007acabde28c47fdd876bb4f0c1369dffda164b	478.68	19921074.672521245049397668	3915069	3	0x1da83fb49b9b7e805ce7ab25e5353d6aa110543a07ffa978b52fb56230c26134
2092	0x0000000000000000000000000000000000000000	0xe07d9f9083190efeab2fb35668cc7910757121b5	215.406	19921290.078521245049397668	3915075	4	0xf0b02519e6d428f97fd355f0c8ee35eeaf52ed4fe00aeb3c3df373a89880e706
2093	0x0000000000000000000000000000000000000000	0x32f14b5393b465596977e04f2e8d8c8f703ab02e	124.4568	19921414.535321245049397668	3915076	63	0x886d53cfc3c8745c34ac7eb4db760c43f1f85230288b23c96425ecbca0ee6bb8
2094	0x0000000000000000000000000000000000000000	0xaaeb5a3d0bddf5aed2bb2423dbccc574a3a10bbb	155.571	19921570.106321245049397668	3915077	64	0xc5b84d144549d7a0c906485d2c217e65b2918af8f991d1adbeb4ff02fd00e5b2
2095	0x0000000000000000000000000000000000000000	0xd6e61969a965f629f08112b887f7868479a7d065	3829.44	19925399.546321245049397668	3915078	7	0xaf54d3e24f616be540c8882a2990a818dea3a6c7cb1b215419602fd2ee258ff3
2096	0x0000000000000000000000000000000000000000	0xc7080e14c3be68ef1d08bbec36d03989a75da704	1436.04	19926835.586321245049397668	3915081	101	0x6f08f8f6c7ccdf6408d21b13ca8857686ff6a965a60162134a540ee72bcc520d
2097	0x0000000000000000000000000000000000000000	0x98641a1d8369779b83fa0de298d601dbbf6d6139	957.36	19927792.946321245049397668	3915081	115	0xdb0bdb69e451611126189eb5e594c8caf9b5185aab6afb51a7c8dc0f05ed97e1
2098	0x0000000000000000000000000000000000000000	0x1b13ec9c98ac94497a05583c83b09004f60f8630	167.538	19927960.484321245049397668	3915084	107	0xcda92b0be2121fad423a988af29ea14dd1e5850a988d9d48894c04917d482f4e
2099	0x0000000000000000000000000000000000000000	0x987142ca98568a939e66c7defe1707b7d5986073	9.5736	19927970.057921245049397668	3915090	60	0xd4524203a5b4dbe8c9357f94e078768bd678b171e4f6e6b72e84328276b16c70
2100	0x0000000000000000000000000000000000000000	0xa3c5ea7e866d8a83e6b7c49aa60db523b0dbf1e3	478.68	19928448.737921245049397668	3915095	13	0xb90eeba86f06c7db82db5db9b0d60eecc1ebc426a354a4572f0e4e9fea38d93a
2101	0x0000000000000000000000000000000000000000	0x8e633af84fa9686369859d9815354b5777283d68	2393.4	19930842.137921245049397668	3915097	7	0x92524ac9b1c682412f6dfffbaf8498941da527ce570eeb9afe82efa214971250
2102	0x0000000000000000000000000000000000000000	0x9aec7a4875c539c3a9bbb3094bf0b9385344d0b9	1531.776	19932373.913921245049397668	3915107	13	0x081b9190eb9a072df5a65a8ed23ccc879b41c20ac906b191ea6bb7eeaf44416a
2103	0x0000000000000000000000000000000000000000	0x3c0bc225181de009484e13b91fdbe74a132b67f3	239.34	19932613.253921245049397668	3915109	1	0x714255cf7a2e39923e67185f284784437fd53c85755a3a253593944690328f75
2104	0x0000000000000000000000000000000000000000	0xddfc3bb005d9f912ac2f9abc053550b7b00f2df2	80.293495992	19932693.547417237049397668	3915109	87	0xcf1bafcb255173ab5c461d2c5c6ea909299bc092e5f660102d294b84cca3ec2a
2105	0x0000000000000000000000000000000000000000	0x4fb34e3bdf2728dd4834c28c2a3f233b43809c90	10291.62	19942985.167417237049397668	3915113	51	0x001c7a7b0c02390d5812c0302339bc151eea6b9f2e2097c3c1a66a4ac176c1f0
2106	0x0000000000000000000000000000000000000000	0xa1ec7e2d2b9a04fd53c2c252d7d29c1a5220237a	1941.0856944	19944926.253111637049397668	3915123	1	0x874efa5dc7885d22e4662466cb946ec43ad191687a29509d78b62786413872c9
2107	0x0000000000000000000000000000000000000000	0xb3e0b76d843e5a89d7ff71af5b81fe414d1332af	481.0734	19945407.326511637049397668	3915123	34	0x6817900f39e23acff713e15a98a8ed344e553f6f8eed4359fba791dc4b89a71e
2108	0x0000000000000000000000000000000000000000	0x002f331dd9949283c6f9f9b1833dfcdcba874740	7180.2	19952587.526511637049397668	3915136	42	0xc8e06203188eda08ec8133bf319d73d56e69b9dae46c346bacbd1906ce535bac
2109	0x0000000000000000000000000000000000000000	0x3e2ee1b447815a295be9966b8387fb59299214db	2919.948	19955507.474511637049397668	3915143	3	0x5881d13e6db0970bf16a410413d247c3a6e142f304242c8640808edd72fda0a1
2110	0x0000000000000000000000000000000000000000	0xd0c733ce907e53add32681697a0c885b7a6f2cf2	957.36	19956464.834511637049397668	3915145	4	0xa9a2e44e344d5dd2c827c704672dff42411c5b58d496bcb7ee7b0bcdc534769c
2111	0x0000000000000000000000000000000000000000	0x9ad89dc58349a4f2dbb45c6ef16dd3580d597d20	1627.512	19958092.346511637049397668	3915145	49	0xf34bf9151a7d2b2d731ea5f51db4f9f07cdfbbb88e5c773425a5d953458b5863
2112	0x0000000000000000000000000000000000000000	0xa935abd1a6206f89e2fe7876d0e6546e0d568c08	5026.14	19963118.486511637049397668	3915147	2	0xc8e972a507c6c46326b33436be08ed5b563c25b7a630fdddc90c5e00e673ecf9
2113	0x0000000000000000000000000000000000000000	0x696dce52ca0a520dd9e4e3137d77a4ad386f00a0	47.868	19963166.354511637049397668	3915154	147	0xb23cf2a62ba7c5539222bfa5d3fc6bcea14bbbc74ebdfaa92663ca79e30cba52
2114	0x0000000000000000000000000000000000000000	0x0087dee6195491c315698ba2d20cf0f6de4f4222	14360.4	19977526.754511637049397668	3915155	2	0x82d1ec6357048a712d9ba88a026f233ee007beef05d9c7b75232d6be071b9901
2115	0x0000000000000000000000000000000000000000	0xb7301419339fb7e63a0a8d181456058825c1ea48	622.284	19978149.038511637049397668	3915155	18	0xf1e559092c31d4aa44f133b4fb6343f6c1de595b65bebeb6d8adf1cf911459d1
2116	0x0000000000000000000000000000000000000000	0x88238ef112b2f1408641d7e1bdb4fad6dea1cffe	478.68	19978627.718511637049397668	3915158	53	0xbaf4523ba0af87f31ca96693cad5c514da150ffa396801b385d907aa3a1b0046
2117	0x0000000000000000000000000000000000000000	0xec9d33f9a515a434fb7c2d7392d8a58c34ec6733	143.604	19978771.322511637049397668	3915160	71	0x2ddd60ec76b777ba1e6520965f27b6d15b0112546d1da759a7e63f3ce4425477
2118	0x0000000000000000000000000000000000000000	0x2b722cf82a73b451893e4f05ba04196dee5eb57e	478.68	19979250.002511637049397668	3915172	85	0xb3b00a95a280d9007b7279c073cb54e8aae7f4fc1c3cd70383ea166ac30b67bd
2119	0x0000000000000000000000000000000000000000	0x2a72fe553fd2ad14987a1b298b46431265ede563	752.3241339260616828	19980002.326645563111080468	3915174	59	0x69f6bebc478cd7ed85fa7c16f0c52e845681372853a6cc32b9041fe3cf7020c7
2120	0x0000000000000000000000000000000000000000	0xa8638085d18c050e0d7780e557a21b5e028f4d70	1436.04	19981438.366645563111080468	3915187	19	0x7b0036968ba98708e9b6a84377ae84140c80b344aaba5050c6a22c1d1780c76f
2121	0x0000000000000000000000000000000000000000	0x6460b52f7f8082756c2ea78f8d6b9ce5204a1cc8	239.34	19981677.706645563111080468	3915196	23	0x04a4d8ea52d78b19c4261bde3e13b229cebbc387cefba18510849096e770a7bd
2122	0x0000000000000000000000000000000000000000	0x9c54d6c9662020692d862356639e971ee8e31601	478.68	19982156.386645563111080468	3915197	39	0x20b73d5479eb9b4712621b1743d5af687509912ca77eae721f6c9eccf9c82c71
2123	0x0000000000000000000000000000000000000000	0x89675ff1bebb4cc0e7c61e4a8963b0ace85baa4e	47.868	19982204.254645563111080468	3915208	35	0x7bde49cdab6ec2da05c7ad9f2f4639adf55d89df75796bd52f7d54d6645a64cb
2124	0x0000000000000000000000000000000000000000	0x89675ff1bebb4cc0e7c61e4a8963b0ace85baa4e	957.36	19983161.614645563111080468	3915221	104	0xafcb6dcba888e1f0798979ba00677fed9c12a977c225b2265ad78eccc81f43fb
2125	0x0000000000000000000000000000000000000000	0x00650a696b02607e99e273da61b6c0f566bdd7ef	1436.04	19984597.654645563111080468	3915226	4	0x3102dd548f5f0e99146055fb0bf65dfe5f094d44859e11ba72e9e737c8c7211e
2126	0x0000000000000000000000000000000000000000	0xb2332ea4b1c8a01893af2c0407f8d6985e923a1d	478.68	19985076.334645563111080468	3915239	53	0x6462648d554d9b0cd38b30a2709c9752e747ed4838f61fcdeb3e52d353f23d92
2127	0x0000000000000000000000000000000000000000	0x241ffeb0bde8f16673c6751443978dbed019de6e	239.34	19985315.674645563111080468	3915239	93	0xe1ae752cf004988bd1540d682adb10073024faaffdf6c37b7218310181cf0bd1
2128	0x0000000000000000000000000000000000000000	0x75a026e50c9b662a5f88ae7b5cb33401b38db8d4	47.868	19985363.542645563111080468	3915241	67	0xb44bc4be49318f886d63ffe1b2c2dbb0fd1080184ba6f4775b6d310144547048
2129	0x0000000000000000000000000000000000000000	0x6b3965316e6ea03541f2d3fb3ee7b4508b1f44ed	29.19948	19985392.742125563111080468	3915243	53	0x027d3645af7fee7686a0958156a93beff571d1364dbc8f1299258ed77fac8794
2130	0x0000000000000000000000000000000000000000	0x1f3a03a35f490a2c039086c63b3bbeabe6a99ff1	143.604	19985536.346125563111080468	3915249	49	0x553e016189b11a12d22cf1464ff4e93dbbe042d78b6d930e05d4f0db8dce67f4
2131	0x0000000000000000000000000000000000000000	0x6b3965316e6ea03541f2d3fb3ee7b4508b1f44ed	3.82944	19985540.175565563111080468	3915251	24	0x1af55a395b382fb46629db3d30311b43b28fb47dc1fc3cb4f5efdf0e542d931e
2132	0x0000000000000000000000000000000000000000	0xb571070ad12c0808aa6b00cc04c5b3dbac9fd68a	38.2944	19985578.469965563111080468	3915254	0	0xd749406ec26206d9fdeb9ade5551f749a19f0075e24b389b40f60ab52ef3ed75
2133	0x0000000000000000000000000000000000000000	0xf50594469d6ed6c082ef38f3f8aaf51f86f0daab	95.736	19985674.205965563111080468	3915263	4	0x863684f8b6076682cbf75705ec1c7c5dff8e353057951d4c2491061c5bb28245
2134	0x0000000000000000000000000000000000000000	0x75a026e50c9b662a5f88ae7b5cb33401b38db8d4	47.868	19985722.073965563111080468	3915264	2	0x27c944694b10dd35775585704e3231a7f10cd2d531b25b7da0bfef48a4db6a13
2135	0x0000000000000000000000000000000000000000	0x8af6e966d78ae4e77b25640a72fea8189d827e96	71.802	19985793.875965563111080468	3915267	11	0xcb00645a07471bbc3e1709ac431113beeb9ac6075b458cd6448cc82b5f76c10a
2136	0x0000000000000000000000000000000000000000	0x89675ff1bebb4cc0e7c61e4a8963b0ace85baa4e	478.68	19986272.555965563111080468	3915270	89	0xec858ed532385891750abd042e143998ac5b11926e5e6802558c2f4168362229
2137	0x0000000000000000000000000000000000000000	0x09b8b644fbfc6ee8e5dd0f450a030e5f381a5cfa	5265.48	19991538.035965563111080468	3915274	32	0x43b049dc6eafd5239d185f7ead3932cc7ed552536e97ccfdaa63b220138236d0
2138	0x0000000000000000000000000000000000000000	0x9aec7a4875c539c3a9bbb3094bf0b9385344d0b9	6352.0836	19997890.119565563111080468	3915278	18	0x4a32548b044991a564f6ab5dad6d4023927469a29985164ad1e3d7d924eb88c1
2139	0x0000000000000000000000000000000000000000	0x75a026e50c9b662a5f88ae7b5cb33401b38db8d4	478.68	19998368.799565563111080468	3915278	19	0xad16457e1c0a14af5ead82a0afb72f939b1d806e330788b3cd88ba8f9f0d683a
2140	0x0000000000000000000000000000000000000000	0xd3ae4457892a8f5148a6987d2c9ce333c5bc55b9	478.68	19998847.479565563111080468	3915279	101	0x940de3080b9b9976a671a2168763cd9903a7422065add066cae853b3b3bb9fe5
2141	0x0000000000000000000000000000000000000000	0x00e8bf3d5a099ca807ec507ab48c307e5aa09a53	4786.8	20003634.279565563111080468	3915287	13	0x5200adbaff1b3a582337f744380538c978801dc0645668f9012264bef4889a48
2142	0x0000000000000000000000000000000000000000	0xf75131ea73b0e11ced6bbee2ddb535500205f53c	3786.3588	20007420.638365563111080468	3915292	36	0x3db2ce79bfe45c9df159e4401b33f8681334a3472307af77f6c352f482d2692b
2143	0x0000000000000000000000000000000000000000	0x292988bf4b910924a420607d9db691e7f2a31e1f	3359.5167182196	20010780.155083782711080468	3915305	86	0x9e144131ff52d6b33233572065f9d01078021122d5adcb9b6603b543546939d8
2144	0x0000000000000000000000000000000000000000	0x9c96b377ace3f98cad190c08a11fa4fb11684442	2862.5064	20013642.661483782711080468	3915310	51	0xcf95f0818d9bc9c802fb63efd21cc9efc9a220029c4e871046dcd05421849e74
2145	0x0000000000000000000000000000000000000000	0xaa738eba50c492d802a0c559423a3c12348d4dee	957.36	20014600.021483782711080468	3915325	21	0x4aed7bc40ce7e423cf4f8dee129825c9f9479b2ea24d33d84d2888fafdcfe85f
2146	0x0000000000000000000000000000000000000000	0x2ec51cde1084f94db3250b2a00747110fa54de08	23.934	20014623.955483782711080468	3915327	108	0xdf9a4eeeee08270869dad1dd21c28dd274cc73c2440d6a9a26c876cc7bfaef6b
2147	0x0000000000000000000000000000000000000000	0x09b8b644fbfc6ee8e5dd0f450a030e5f381a5cfa	1902.297063141938972732	20016526.2525469246500532	3915330	20	0x49f8d3742e39f01bbfb5144c0698836290dc4f4462f6409ab97f1dd24bd7f041
2148	0x0000000000000000000000000000000000000000	0xee0f9a8904b6d29e7ca0fb1d6931c799e947f202	47.868	20016574.1205469246500532	3915333	2	0xd308c95cc745d70e5f4b84503f66ed91ee0ca211be3c93488725427cf67dacd3
2149	0x0000000000000000000000000000000000000000	0x2c86515882530be8b8e153f65ed9534155753281	1890.786	20018464.9065469246500532	3915334	28	0xaefa15b3bcf05bee1bfef9c7a1e91e4054fdd37054a76c95c9e98e6885e43878
2150	0x0000000000000000000000000000000000000000	0x3b05cfb09d198071a779d4c1f96a30b008776673	317.621340678	20018782.5278876026500532	3915341	2	0xfe525892942b3ee87d4afdb6a00016e9f9bebbe1f5cb8a31d2a2ff597c5e3740
2151	0x0000000000000000000000000000000000000000	0xccf0f2913e47d515975ae89973713b9ae9bd868f	478.68	20019261.2078876026500532	3915355	40	0xc374b99a9635add123de1713046a94f1c0adff20058e6ed4bb7067c52c760661
2152	0x0000000000000000000000000000000000000000	0xccf0f2913e47d515975ae89973713b9ae9bd868f	1100.964	20020362.1718876026500532	3915366	61	0x807ff9bafe98a7791652ebcb30c7e8f5163dc1cc004d88c1fd26487f3a3c1965
2153	0x0000000000000000000000000000000000000000	0x5865c90dc62ee5c5eb02ae3fbf778e335a4b8772	239.34	20020601.5118876026500532	3915368	48	0x1b3c5c93c66ac6f3e10ae23e1b28d5f3f5600e162e4a47534fb6a5cf91ae118a
2154	0x0000000000000000000000000000000000000000	0x663597f0cc515ddc5b7eddd96ef5551726453aee	10530.96	20031132.4718876026500532	3915372	126	0xbab9ad26abcdec224460b16504f6a08b2e86acb71fabd0f7a68121f01e3dcd31
2155	0x0000000000000000000000000000000000000000	0x5865c90dc62ee5c5eb02ae3fbf778e335a4b8772	1436.04	20032568.5118876026500532	3915376	51	0x00719f88be62f2276dbc6884a806863503ea24afdbae6d4d6ac936e764ca021e
2156	0x0000000000000000000000000000000000000000	0xa828055a5a8df86b6526acc09d025b4efa9a0a67	478.68	20033047.1918876026500532	3915379	57	0xc4b4dbcd237313931b024affdf74bf882639815b39a91a5c038703b5792074e6
2157	0x0000000000000000000000000000000000000000	0x1b350087e980a4d6ff00bf9549d2df01140b1cc9	11679.792	20044726.9838876026500532	3915382	4	0x4c4b11c214ac9d8fc848d02b68c0ab307d5c2904a1aa452c4ed3a16491e0eced
2158	0x0000000000000000000000000000000000000000	0xf6334f3522c7e8e69d82f99074732c9762a17656	1384.931444103	20046111.9153317056500532	3915402	111	0x3b62183084776a49f21c19765b418bcc679f1f6d1ebd489100284b78b3478887
2159	0x0000000000000000000000000000000000000000	0xa828055a5a8df86b6526acc09d025b4efa9a0a67	957.36	20047069.2753317056500532	3915404	38	0xafcdf1859fc4a52f546d6b8ec8f37760efdf3e1b8c0b199a9b282a36a31291a5
2160	0x0000000000000000000000000000000000000000	0x62572483fe3d714708dec82bb313365fe432375c	150.7842	20047220.0595317056500532	3915404	49	0x19673e4a3b767f50194f04a49bb0a58f496df1b231be1b98cc6b52e5cd8b0e4c
2161	0x0000000000000000000000000000000000000000	0xe18a6d5c65ce71926948e580cc67bbf6fb26f76c	287.208	20047507.2675317056500532	3915407	3	0x440d907ea31346a06a0d0afb04c97445e96688b3c1c7774084c0af6ebb72ae0c
2162	0x0000000000000000000000000000000000000000	0xa75062d14b9efebe51a308496521e09369ceb459	119.67	20047626.9375317056500532	3915412	2	0xabe6161e42d552cca5bdef8cbdbc32e795aa92981fb6dcb5284540f0e3773d2a
2163	0x0000000000000000000000000000000000000000	0x6a72b74cda499eb0dac946df5ea4f3447eb58dcc	239.34	20047866.2775317056500532	3915412	34	0x7da5dfcaf307d00de01c4ec4e261488ccaa015afdec42dfcee7e771102b00e6d
2164	0x0000000000000000000000000000000000000000	0xa4ab643a247710214f3f02162ebe4514d1c0fbe8	478.68	20048344.9575317056500532	3915425	94	0x226156105c1b37555c74b3fc07d617d993b4f306e41398dcdfea8e852937756b
2165	0x0000000000000000000000000000000000000000	0x5959803315e7da718a5144891062734ea691b313	1292.436	20049637.3935317056500532	3915433	2	0x0d9876464eadb06a99ba18baf02e4d9c4f1017db00bf3a16eb73f7b59240b77f
2166	0x0000000000000000000000000000000000000000	0xc43992c73be9453e5ad9bcc631685cd165e03784	957.36	20050594.7535317056500532	3915433	8	0xd5c1dd75fd14e1536f76e74122176a2ca5e975be4b66499947b487242facb730
2167	0x0000000000000000000000000000000000000000	0x696dce52ca0a520dd9e4e3137d77a4ad386f00a0	425.06784	20051019.8213717056500532	3915435	49	0xe76ee53d23733a6647e55ac2930fd6a8636ee474255a78059bc7f9ab7d51c0d5
2168	0x0000000000000000000000000000000000000000	0xd5b02cf992f6748c894a46476ef8825134d2a060	239.34	20051259.1613717056500532	3915436	30	0xa7c8dc40058f574a445f1de1e59c6bb74c958ab281362dc176f6ce90862754da
2169	0x0000000000000000000000000000000000000000	0x841c223d5f95a44e03d0b97683792399cf830d1c	47.868	20051307.0293717056500532	3915439	2	0x64f26eda51d2f5ff277c309f6404c8eddba9dc04a5664602a4da486a8179aaf7
2170	0x0000000000000000000000000000000000000000	0xcf20c6e10ec8f0e1ba066b818663f53f9318c467	19.1472	20051326.1765717056500532	3915459	5	0x6e83d280ded30856e2914d4dc2fef0197bbcd009edd394e2660079951d4ec4d1
2171	0x0000000000000000000000000000000000000000	0x0190bce30adce7bf505e5a64a86a69c09c402e79	3494.364	20054820.5405717056500532	3915468	91	0xccc512116b224d51526b2821ed45b8d6c6ca30ab528de8ac3963bc3091e080e6
2172	0x0000000000000000000000000000000000000000	0xf378c2dec91b287c066abf41342df7f9d9e50697	1914.72	20056735.2605717056500532	3915488	2	0x26195885091e934a4a2194271e4dcf9562d6ed42089fdd363b821d973bc21e63
2173	0x0000000000000000000000000000000000000000	0x00d839a33c75a14be0cba595a9bb900691300dd8	478.68	20057213.9405717056500532	3915493	83	0xa34b6cae26ee431ef7741a56deab3282f240a20d77de3481572d72c7105e0a90
2174	0x0000000000000000000000000000000000000000	0xb9791c6414951d6f14cd68332fffaede59badba7	478.68	20057692.6205717056500532	3915503	21	0xefcdf8bd79c61f8532e0802666cf69a7db388259c8533a23c9dce7538946d228
2175	0x0000000000000000000000000000000000000000	0x01fb009d5b0648a7e4777f28552ecbc40709b41a	0.57776676	20057693.1983384656500532	3915506	9	0x6c480d617bf000b8b3b6d57c561469b06fef8428dd081ac6dc696ef0f9d2fe25
2176	0x0000000000000000000000000000000000000000	0x74a70b57a6bd61d2481c3a9387bfd4dc0583d025	174.7182	20057867.9165384656500532	3915513	9	0x3d2bd06fb56f2b1faf681dc93957b2a3f574862237d48d28aa764fc0308169e4
2177	0x0000000000000000000000000000000000000000	0x9e36ac0364ed1e9401bd2d197577661532b853d9	718.02	20058585.9365384656500532	3915513	61	0x9a740b6852840edcd6506873ab90ad0b0f07e293db0264d4c54c2070b8e63d16
2178	0x0000000000000000000000000000000000000000	0xea83cd066c97217a80adac64d662680c1bf1453a	182.3635285692	20058768.3000670348500532	3915514	16	0xb5d1db171ff8bffdb9786e401bba84606a676f62fe227237d8e2b313c3d718d6
2179	0x0000000000000000000000000000000000000000	0x00d839a33c75a14be0cba595a9bb900691300dd8	478.68	20059246.9800670348500532	3915517	29	0xa1ddd7799589beba72f9159bfb3c7e7176a69a289155ba8ac07b4b77961b86ae
2180	0x0000000000000000000000000000000000000000	0x9e2223412fd28cbb75e2b3b0c0f48559ebe92801	478.68	20059725.6600670348500532	3915519	8	0x2cb3871c13b73a08e9fcd136557e9b475e0ac015e93284205ec50fbba11b65e1
2181	0x0000000000000000000000000000000000000000	0x357bd52e91ede729600181998cd83165c1b4a5e6	478.68	20060204.3400670348500532	3915522	8	0x7dd41dae393598fc15d116021bb8e6d38403beba58d4297fe20575066c9aabac
2182	0x0000000000000000000000000000000000000000	0xc5d8ad35c22cb1d138d8c0936a0765ac140d6b75	23.934	20060228.2740670348500532	3915522	24	0x8a8776c4f43388fce108e2b891aa98545f572e6f6b507abfb6dd279c72122625
2183	0x0000000000000000000000000000000000000000	0xf378c2dec91b287c066abf41342df7f9d9e50697	478.68	20060706.9540670348500532	3915524	6	0x110c32e9292a808485af685797ecf1c94a7945683082147b8fdb854c6a86d2e2
2184	0x0000000000000000000000000000000000000000	0x8f28e8df07a83323274b7982a65a4462e69b22de	12924.36	20073631.3140670348500532	3915530	13	0x0da9a926406228ec16343ee3802e622e23857a49213403503d02cf0d76f9c88f
2185	0x0000000000000000000000000000000000000000	0xacd0fa618b9681248cdc4eec93f3c06ee32548dd	421.2384	20074052.5524670348500532	3915532	54	0xb19db27bb3dd9a8f04c4d2da338410772a28b03c59c2e984e774285391c83c1e
2186	0x0000000000000000000000000000000000000000	0xc5d8ad35c22cb1d138d8c0936a0765ac140d6b75	1100.964	20075153.5164670348500532	3915543	8	0xcce7190ccd5d279dc62dd15c9077e46b6c63137a846a8649bdea8c22d3bbac64
2187	0x0000000000000000000000000000000000000000	0x1cd620586a3ec2d10ebd0d02baff4123a59f73bd	238.492844103	20075392.0093111378500532	3915564	54	0xb6daac951d18fd49fbfc0e6297b54b795bd01bcc4a69c883d7c8446db5e2dbbd
2188	0x0000000000000000000000000000000000000000	0xdf31de85deaf78407415105912546f6aa5404a8d	2175.12192	20077567.1312311378500532	3915564	55	0xb72af574c296cc39f0012a0324fb2217ce6c3b11c54721e7aded50fcd338c60e
2189	0x0000000000000000000000000000000000000000	0xddcd4878251a524ec5db227824967e68875ca7fd	478.68	20078045.8112311378500532	3915571	22	0x6013238c4467b3f7e496e7512ac1b57fa4f30344a0ec6a272f60189f6fc1ff50
2190	0x0000000000000000000000000000000000000000	0x0d228ef1e58117a07783f0c17ba1faa7aca9516f	4786.8	20082832.6112311378500532	3915573	91	0x4e09930b82bc1debc64d97548e194e928366848d75392c464696db1fde5575c0
2191	0x0000000000000000000000000000000000000000	0x01fb009d5b0648a7e4777f28552ecbc40709b41a	100.5228	20082933.1340311378500532	3915579	15	0xe88a9cd23f14972f222efbaf93a5e29a57af6024ba13f7c83307df33186715c7
2192	0x0000000000000000000000000000000000000000	0xdfdc4dad77da79d1585ef881367440b363ad0bef	239.34	20083172.4740311378500532	3915581	51	0x24a3a8614291d9d725da4cef88293ab909572cc56666d83c2408c35a4c5d107a
2193	0x0000000000000000000000000000000000000000	0xa8e378e6d8802a1652175e9b7c4496eeabfd653e	5744.16	20088916.6340311378500532	3915586	19	0x8e815b4bd1f0709323a55cf7deeaca60f75d1c3536ef5ae83519b5b7e4fcc1c0
2194	0x0000000000000000000000000000000000000000	0xe8252415b22961002785bfd255b46e92d28f195d	430.812	20089347.4460311378500532	3915590	3	0x64f5f1f6bed98f63cd99dbc37c8fc16f209436c43f255391003f92dedd845b6b
2195	0x0000000000000000000000000000000000000000	0x1a655e42c93521a862ac20b460c12eca5fd1d227	718.02	20090065.4660311378500532	3915590	70	0xf5bac64312e8f3d5a92de8634a1deab2f722ccffa75df8d2f310847358d4d440
2196	0x0000000000000000000000000000000000000000	0xe9500755ebea975c690f90b794bc763eb60c4881	718.02	20090783.4860311378500532	3915590	80	0x566b24e277674eb3f086c801f06c525e0ea7189da417658c7e57df1121f170e4
2197	0x0000000000000000000000000000000000000000	0x57a314b850b14cd19dc6c99bbf99d1ab5a098d41	6748.28081316	20097531.7668442978500532	3915601	0	0x36c53719685eb97366bad4704f544eece73aee29e3428e0c495b6ba1de1d6a2c
2198	0x0000000000000000000000000000000000000000	0x47dac3ea416928cda5101a6ded89611e9b174840	478.68	20098010.4468442978500532	3915605	8	0xed783da514e85b13fceeb826cb92fdfe0d2a700b8850bf70c85700bdd1aefbfa
2199	0x0000000000000000000000000000000000000000	0xdea05af568dbf778602f29f4cdd8b298a9c45c1e	477.832844103	20098488.2796884008500532	3915616	29	0x5b1d90a641311bfc53a90d7fe91c706b7bc6aaac630dc137dbdbf3b871cc7b4a
2200	0x0000000000000000000000000000000000000000	0x8e9e77ebf49aafe4f6ba2a350d39b98e8b199a1f	1196.7	20099684.9796884008500532	3915616	33	0xb1d7870a263f6a9dc769359a3684eafaa76a775d56289c261b163ec5546e6c8b
2201	0x0000000000000000000000000000000000000000	0x326619fd3fb4ea3a62589d27d1b9ebdaf89ceb5f	164.66592	20099849.6456084008500532	3915622	16	0x6bd28500d15148e3383c8b29232c5d15c6a145c41b08152346fa0ea319d388e6
2202	0x0000000000000000000000000000000000000000	0x7955ef4579f3d192ff3413533a9127a6e7c60a6c	185.24916	20100034.8947684008500532	3915629	4	0x61ab5a1bb04abface0067a1ff9299491eaa246f8c4729b64625662ece893ded9
2203	0x0000000000000000000000000000000000000000	0x531c9d11af44d6da0ec412d32a75a507c26d5e02	957.36	20100992.2547684008500532	3915637	20	0x0eb1edd1c3800d7bc542f558d9e1dedbb018490bbb2d0dd7a36f1f8f0a7ffc1b
2204	0x0000000000000000000000000000000000000000	0x198f14eff7fd684bf8197a4f3d588906720a1332	2391.48528	20103383.7400484008500532	3915665	80	0xd627c55d1cd64a375aa4c2db20c3937b2e6cf7d056a2b788d93b660ee89178e1
2205	0x0000000000000000000000000000000000000000	0xae3cdf82a7c558c829b56ce0472a384429ce0970	1924.2936	20105308.0336484008500532	3915667	84	0xd2f654943c428afb548c5e53a421908a0a07f168c3eeb90b10111f09ede8e260
2206	0x0000000000000000000000000000000000000000	0xdbcfe9546f9b84d3879d72e40d332e6630c42d97	473.8932	20105781.9268484008500532	3915668	78	0xa4aec42015e3a3a565261d2d6e06ad82c0488e9401d5d4391a3ebf471cae133d
2207	0x0000000000000000000000000000000000000000	0x96a92013af5e829d5ab97ed950e97fa58266429d	957.36	20106739.2868484008500532	3915670	49	0xb7b83d0775de0564993210a402f3d5a50c290063fbc46ab1e258e879f1371dc1
2208	0x0000000000000000000000000000000000000000	0x0424ef881c897a3a2a0d5270ffdea7adb8379988	215.406	20106954.6928484008500532	3915677	3	0xedffcc87b1a49bd1ea3d755e89ae33e879bf9721ad4d61d355d5947b798bafa4
2209	0x0000000000000000000000000000000000000000	0xce801037094b65584d3b1852d3ab51b71fba1ce5	23.934	20106978.6268484008500532	3915677	14	0x02eefc15c972ba2a642ded6897056cc84b91371f8c33765805b98a03ff623ce9
2210	0x0000000000000000000000000000000000000000	0xbd99a1ea615c5043985d2f4ae59da4459f14e7d2	2393.4	20109372.0268484008500532	3915683	14	0x6f306534ac7bf0c780a78bf4f3df7d09f76995878749dd5e6a11ef62ef716cb4
2211	0x0000000000000000000000000000000000000000	0x0df2797353d9b5d06cb25e8531079ad080a198b2	69.9999899928	20109442.0268383936500532	3915685	15	0x2cef47b03ffa287601659de23a053c8af7c249d1e51c4c8c6246cfce7d98ba00
2212	0x0000000000000000000000000000000000000000	0xa6a3c95dd7d3edafca3e90b582990fafdf572a82	2197.1412	20111639.1680383936500532	3915685	26	0xf93317bd69138052dd119847fe93908620cc8946dfcd4443c43816dcb1431659
2213	0x0000000000000000000000000000000000000000	0x95e694efed86b9fe6f49699e4ada11334398f516	17.9943446946	20111657.1623830882500532	3915686	86	0x7eac6cd5c036515856e8327dd840990a1fb50a9d2f02fe6eb70e505743f97597
2214	0x0000000000000000000000000000000000000000	0x5f467025429ee4a67291cd916e886ddb776786f8	57.4416	20111714.6039830882500532	3915691	14	0x8bd4e7fe89b3cb804f0f818d38b7a3c7d208e9fb0f0a45c26836902c43b7404d
2215	0x0000000000000000000000000000000000000000	0xce801037094b65584d3b1852d3ab51b71fba1ce5	349.4364	20112064.0403830882500532	3915691	90	0xd4cf0649be757edfa1dc6430a8fe138928069849d3633828e5d4d1b4c18916d3
2216	0x0000000000000000000000000000000000000000	0x2ea696fa7f70a6a9b5ea7766ee65928332504434	177.1116	20112241.1519830882500532	3915698	9	0x500c1c3f167233d9a7220d7e92286d014f37fa4669c444892278148a38b0fe66
2217	0x0000000000000000000000000000000000000000	0x0de8e811096d1a28d25e10ab5bcdf0df3427072f	90.9492	20112332.1011830882500532	3915703	61	0x894dfd45cdb0a109d3e796f1173cee9bb2951888f09407a8b5851dbf92c7d4e0
2218	0x0000000000000000000000000000000000000000	0xf3120b33d4c09a5492acd26e4a8c11185ba41c91	569.6292	20112901.7303830882500532	3915707	36	0x66674b7bb4b3adc413f85cdbf1904fdf88904169b62a0fccae3e8d45da5b4057
2219	0x0000000000000000000000000000000000000000	0xc56bf871a86d3ac947cad3bc6e4329f3aac2e083	47.868	20112949.5983830882500532	3915710	1	0x4aaa7e57badb385cf0bb552661845c3db8df0d5d6cddbe4e22ad74619ad2af96
2220	0x0000000000000000000000000000000000000000	0x9973c800a7f5e887ab7ce044755d139b3fbfc2a9	526.548	20113476.1463830882500532	3915710	78	0xb12a6f7a5e140bb57b467d300d53f2e40f3b296974a868bb6d1c30ce0b05f046
2221	0x0000000000000000000000000000000000000000	0x85c80a9f7eaa0073b6ef18056ba574e29f208240	478.68	20113954.8263830882500532	3915710	88	0xfcf5e33c6d540b99aae9455d1f0a03658d9bad56e027f30c5d6c6497901471cc
2222	0x0000000000000000000000000000000000000000	0xffd011cc6737e113dc8ba4b2cc294e656e9d8f00	478.68	20114433.5063830882500532	3915713	5	0x97da426345519626d0996f1e504efcb95929af21fc82265d779e21e4f80906d2
2223	0x0000000000000000000000000000000000000000	0x3e2ee1b447815a295be9966b8387fb59299214db	263.274	20114696.7803830882500532	3915719	36	0xc0de7a849d28cf9f4b5e95299159e5263460d07b0312f635d64169ac662bed4b
2224	0x0000000000000000000000000000000000000000	0x1c3fb283ed59a30535552a0634f8c1340a2158b9	167.538	20114864.3183830882500532	3915722	115	0xaa4ee20e8bc031fbff542abbfad712710fe0849e70995349d727e6de4a642c4d
2225	0x0000000000000000000000000000000000000000	0x4438c0f9b75354165e5f1894e0cb6ba3d254d9ea	478.68	20115342.9983830882500532	3915722	126	0xb969f5e9545adba0f17d3e7e6d0e722cae4860fa474b0a6b2bc7155c3a097297
2226	0x0000000000000000000000000000000000000000	0x9df712a77bed41fdfc97edd44ecfafd76d0bc2d0	97.89006	20115440.8884430882500532	3915725	98	0x4cdc5cdbb81aede46dfd9075c3fac6d2e754c3eb741048b5eb25070ed4329866
2227	0x0000000000000000000000000000000000000000	0xd5b02cf992f6748c894a46476ef8825134d2a060	239.34	20115680.2284430882500532	3915729	98	0xa265fc37049622288e348da86c040f23b78d537f45d48ce5f1cd4eb6a967d89d
2228	0x0000000000000000000000000000000000000000	0x82764a229a6e359e0ef476666f6842c3121a736c	478.68	20116158.9084430882500532	3915734	1	0x8942cd4e93ce7b260fa161e3dd32ec331bba6cdb0bd43c54a750f406fe671731
2229	0x0000000000000000000000000000000000000000	0xaf308156c2a172747592111dd4c01fd1c739d9ab	957.36	20117116.2684430882500532	3915735	26	0x2f5a2e90b4b8517aaf6c3d07d429cb00abc0d43bd6622dedf75fde34716638fb
2230	0x0000000000000000000000000000000000000000	0xfdb577d55a6f5595431aee48515f87ba2fed4ccc	2264.1564	20119380.4248430882500532	3915738	19	0x6261c46b98ef1e3241e2cc40552e0687efd42e77a1ab2c32ac54bf16b195b50e
2231	0x0000000000000000000000000000000000000000	0x19303d8d6e92cff8f4fa5945b0b53a7f47a35b0e	1436.04	20120816.4648430882500532	3915745	5	0x49a972a4d2acb6b6d43df21963826d7dc5d3fc82f02411f3caa248a747c76413
2232	0x0000000000000000000000000000000000000000	0x5c89abc4cb465cfd640bd3122ddf4f8ca76b466d	359.01	20121175.4748430882500532	3915754	73	0x56c585b31e8aceccbe0e72382d25978b91689e688fac04f7537903c96b424697
2233	0x0000000000000000000000000000000000000000	0x235593756cc9b1a4df9f0f2153c6833a0803479d	478.68	20121654.1548430882500532	3915756	102	0x8ed2aa5597d404a1714f9cfcecac258fd1bae82654755e1486c55068e0229782
2234	0x0000000000000000000000000000000000000000	0x3dc92c437639d8b66aa047e4ec344ad07e661ba9	478.68	20122132.8348430882500532	3915757	39	0xb9701b47899795579d9f2a74b6da7e428f7570399ad41ee8fdd2ce31a992cbe0
2235	0x0000000000000000000000000000000000000000	0x00e7e4e893df1dca62032cebcc9b34c7963d1b91	2589.804074394368472111	20124722.638917482618525311	3915757	131	0xec6787d98d2f6302a70ab123fc1678f0a36613e417a4a80f12a86b9b7f3a9968
2236	0x0000000000000000000000000000000000000000	0x8888889201803e468f55333b6b3992b262f61951	9573.6	20134296.238917482618525311	3915758	146	0x718cac421a0da0132530f685c77d3dd9dbca0b9b1d39b51da74d61d358d3a9c6
2237	0x0000000000000000000000000000000000000000	0xa1f176409ddea10f6124c2297598968eb571d00f	9573.6	20143869.838917482618525311	3915760	82	0x72ca5c64a8c1b58a3a240cb0f79bbbab265953363c1dddf4c3e6436e4cffdba5
2238	0x0000000000000000000000000000000000000000	0xe08148dca0d68510cd7451bc88ba7cd1ded93c88	478.68	20144348.518917482618525311	3915763	99	0xa4531416de57a6cf8c639cedb29b32ffdd7bf45bfc456e852db9fc6413eb328d
2239	0x0000000000000000000000000000000000000000	0x1168c1e6b72aca904a8ad4a8e290d6a5db843d78	4.067330095291326489	20144352.5862475779098518	3915765	115	0xfcf93b306ae7e836ce8d724a93378dd5929b23a70f3dc595d75c10ae11cf79fc
2240	0x0000000000000000000000000000000000000000	0x515d7c7509f116be5a637d24b843ad4c4b0365ba	718.02	20145070.6062475779098518	3915768	0	0xa1cbe677faa854198a70454e2688203868eaa3aeac3885ab7a57a15b2b1448d9
2241	0x0000000000000000000000000000000000000000	0xa3158144c201188b08d9c80e84a9e4468e258a1d	478.68	20145549.2862475779098518	3915778	4	0xced1c859b9a9b08c25897331f5ae12da67d7cba822455e189861d779ca2b475d
2242	0x0000000000000000000000000000000000000000	0x949f583d914a0e2f469d9138fc9b9e53c917043b	85.68372	20145634.9699675779098518	3915781	102	0x8ce80ca78c379c62daf279705fa17808f656fd8864a8faddaf73ee6a1cb4c188
2243	0x0000000000000000000000000000000000000000	0x74b67f5741a0b88f4e435a215c2b2142641f6693	464.3196	20146099.2895675779098518	3915782	17	0x6740c6ff104146eb90cfc787d074e05b38059f6e9f90e2a58978eac176232ee9
2244	0x0000000000000000000000000000000000000000	0x515d7c7509f116be5a637d24b843ad4c4b0365ba	478.68	20146577.9695675779098518	3915783	5	0x0c2c1a224e03fb2e51be6916d93f52c6b53f1355fbf0459d9bc29a61746b5fa6
2245	0x0000000000000000000000000000000000000000	0xc7f440d4c45c1ce7a295c788d9cbea9ff627cf8a	478.68	20147056.6495675779098518	3915785	145	0xb7a984769f7f299e18d37dda89a6b7045aa792de36a85ea378068934710bcc46
2246	0x0000000000000000000000000000000000000000	0xe3ed4110a8b6703b11763687a32b3d253d39af67	9573.6	20156630.2495675779098518	3915788	129	0xbe17427a5c991a08b776090de2ba92dda4ac16b9fa6af14ccd3886e795cd91e3
2247	0x0000000000000000000000000000000000000000	0x76b1ad9e0a10ab271feeae910fe8e86350ba4b72	294.3882	20156924.6377675779098518	3915812	40	0x9a1c22ea37af7fe260c93f3cafd344cf67d6bc081d8e9645998b4e0aa115715d
2248	0x0000000000000000000000000000000000000000	0xf5c28fa89201be0a5aedb281d56c186c677f9e5d	2385.26244	20159309.9002075779098518	3915816	12	0x16f89296db67db1fcbd3ad1dc12eda6016e85e081e5e481a01243964fcbc6625
2249	0x0000000000000000000000000000000000000000	0xe18f8f1fe7c524bbaf74692c1cc24b0ac747e718	574.416	20159884.3162075779098518	3915822	8	0xe69437b3636d24958be709f3b915602f3811c1e4c2a5087aa5fae4bcbabf0abd
2250	0x0000000000000000000000000000000000000000	0x5d62b1c8dc78c71d56352174a58a2c7f92c6b9ef	239.34	20160123.6562075779098518	3915825	103	0xada3ec4cf4b088cc0d9fc88e714f9afd7ceeaf10c98767c5632211a1e9cb54af
2251	0x0000000000000000000000000000000000000000	0xb57c362219bc3678afa88a4939e13334c720f7da	143.604	20160267.2602075779098518	3915827	13	0x42e078be647810ab12b5461d79143110efeb9deee95f4f4197a019338aeeb6ef
2252	0x0000000000000000000000000000000000000000	0x9f51e23575e184f51cbbf1249282550307250802	1047.303972	20161314.5641795779098518	3915827	52	0xffb771e1553028be535cbc090a779a7a10d793ab17926f8775688e3ee362e2f6
2253	0x0000000000000000000000000000000000000000	0x2693c4cb5bc1d598cda7e259a671db8b3ae09f6e	471.02112	20161785.5852995779098518	3915839	46	0x36c8ee1537ba6568a56bac8b1582491a3c1b016ffb66e143aabea0349b3f9111
2254	0x0000000000000000000000000000000000000000	0x2d61811cbd24af3c19cf6c09cc4f1f154f56176e	574.416	20162360.0012995779098518	3915853	156	0xce16720f909c3c3ef3fb76916f8632bf0d6254a112cd1b644e4b863a3faa062c
2255	0x0000000000000000000000000000000000000000	0x949f583d914a0e2f469d9138fc9b9e53c917043b	491.60436	20162851.6056595779098518	3915854	49	0x5bf46e62df6558a33a2e9d54891ca259d80b291dce85ba9eef162e824d48379e
2256	0x0000000000000000000000000000000000000000	0x6b388d6ac7ad4b934dbb33eb41aafdfc545640c0	430.812	20163282.4176595779098518	3915854	53	0xacb45f728855d0830adb92cbdd779034876c19497f3a1d31ba068a687276be2b
2257	0x0000000000000000000000000000000000000000	0xa998b95b5b4f2081b2fe7d8207438c44997c7f45	2393.4	20165675.8176595779098518	3915857	52	0x7aa498a121a70e2a2d61b1eff1580f939ee228a37866521b0f664bbe4a64258d
2258	0x0000000000000000000000000000000000000000	0x73a05a20ef402c88d86292570b7851deca6684c5	822.78558018	20166498.6032397579098518	3915859	23	0x6974f269c30a45f3a79c60307ece29503fa4636ac64375e7ac83be1141e3843d
2259	0x0000000000000000000000000000000000000000	0x4fb34e3bdf2728dd4834c28c2a3f233b43809c90	7180.2	20173678.8032397579098518	3915864	46	0x93aa3277115c819db01364f86e18db1c25f769fab1d1f7e0c9146ae0810d8d41
2260	0x0000000000000000000000000000000000000000	0xafea1cd79468c1f3c96d1dc20ceb50a64c576315	694.086	20174372.8892397579098518	3915875	0	0xaa384db6adda46b8c67ad253280c897326f1b601cb2712364f7ceb80db0bba35
2261	0x0000000000000000000000000000000000000000	0x63bf7458572e6014027794cd1b688f9c579fffec	50.6302755948	20174423.5195153527098518	3915876	1	0xdc5f61976e923bdfc9ddbcfa88913a59a47efd8759840c35620232bca8a52b92
2262	0x0000000000000000000000000000000000000000	0xaaf768e2f1cb707c5cf005ea3c1cbaaa18c267b0	81.3756	20174504.8951153527098518	3915883	69	0xdf7a73ffc1263e83845fa1b894d11b490cdd0dcdaa054701866d883a7050e394
2263	0x0000000000000000000000000000000000000000	0xd84f449c80407f8f0e5bd96302709ce4318eda49	478.68	20174983.5751153527098518	3915891	3	0x24bf7c791f213363a5f04c8d6a05f48218a31875da6905d8364d662b1f8d2dee
2264	0x0000000000000000000000000000000000000000	0xb0eca63cc5bb9c6a5c6724c797cfd978748ec685	478.68	20175462.2551153527098518	3915891	4	0x8d95db5e7f2850fe295e0ca8f27f31cd88d5f159b4e12bed8fa7b1540284a7d4
2265	0x0000000000000000000000000000000000000000	0x6392268a7b2cc72497ed1c3321043e7e3d4b0b52	651.0048	20176113.2599153527098518	3915891	5	0xb5f1f380050efff1d21cd5c1b680e48f9f29eadbbb4bba12d1212f95c00a8c8f
2266	0x0000000000000000000000000000000000000000	0xa3f8e3b83987ea205c1c4b78e430107e6716b9bf	478.68	20176591.9399153527098518	3915893	21	0x42378679e7033014c611e01f054376e69be000ee9cf871c38bd7c4848d7a9e7f
2267	0x0000000000000000000000000000000000000000	0x1523de03f84bced92db2599ac9ad0739a0e8d9a6	478.68	20177070.6199153527098518	3915894	3	0x590bf7db874b8485a4e4b10b4ea170a1c0b2abbd1f09d854da8c97b7d6157a24
2268	0x0000000000000000000000000000000000000000	0x107fa40357876ef058ea308c5aa6b6627f565a7d	1053.096	20178123.7159153527098518	3915894	42	0x5d0f3193eaec415c6a0f9999e61dfb7d95128df6d9296e3097d895f4cec4ef75
2269	0x0000000000000000000000000000000000000000	0x9f3cf7cbd7691e8f0f2428e3fd816803f605bcc5	957.36	20179081.0759153527098518	3915900	1	0x294ef8e4c59823754070c12d4d21fa6ebd9af824236ac0d9e051cc5e3dab503b
2270	0x0000000000000000000000000000000000000000	0x936cb97edc817877db1b7af0dda01d142709518d	1196.7	20180277.7759153527098518	3915902	1	0x5e55aa38eb4115d6affc5ca9dfd27a0cadbe111c7f5a1188f5e78c56a51025a2
2271	0x0000000000000000000000000000000000000000	0x605c856945c5c79fa3656845dea37f21d1fcc1ba	162.27252	20180440.0484353527098518	3915902	2	0xa7f8bb209d2a14fd14534c5b9238d8089da080c987898ab8d95066bc80a67ff7
2272	0x0000000000000000000000000000000000000000	0x39ec5ca9296f3ccd50921bc97909ae06db90958d	826.20168	20181266.2501153527098518	3915904	7	0xb815a1c96c439cb1243679b609a557eaed7a7c2eca465b258337e8906f5c458c
2273	0x0000000000000000000000000000000000000000	0xc1baf97bc6bf89e983c6154775f7c5cff8f4b3c5	4786.8	20186053.0501153527098518	3915905	3	0x6b0b493f877ae17d0cbb245da75eba7de8604e8ece3e35424328fd98c2a27f90
2274	0x0000000000000000000000000000000000000000	0x4c64d2dc1b20af77aab340606625c6bea804c360	498.6183192228	20186551.6684345755098518	3915908	26	0x3f4ee2a09042acf76c92332f10ed186a1fb36ffb8b0a2532667aa315d6a10ea0
2275	0x0000000000000000000000000000000000000000	0x270a1ef53981e4a6cd3b87731dd927f16ed86b50	52.6548	20186604.3232345755098518	3915909	2	0x458447dc9b49a1d3ef906c0e6142a07949e829671e628efe8501036e822c65ea
2276	0x0000000000000000000000000000000000000000	0xc6d09d42380e0f0266f1114bfca76e2485f5bc52	40.606568004	20186644.9298025795098518	3915914	2	0x0ac4d43edc9e3abe2b1839c2782bac1226dad9e62c6cd721cc6cf7bdb4a7adff
2277	0x0000000000000000000000000000000000000000	0x54c9d479b9933ac0779c9c828e28ea2336620f2d	473.8932	20187118.8230025795098518	3915914	12	0x3b6c47488be1e10119285b81678c29db90095016fcf940736a81e5a37d5fbfa3
2278	0x0000000000000000000000000000000000000000	0x83e0d38fa2b5caabf8fca602d69c7ace6d1a90a6	478.68	20187597.5030025795098518	3915914	24	0xd96a52ad78f9bc2e4984a8bd2569f17ccea2cd5d824f3d79a171ac51978a6e76
2279	0x0000000000000000000000000000000000000000	0x3b7355049a2579ec530a36e648a68820057ef042	957.36	20188554.8630025795098518	3915916	18	0xd344467c71279c7462f21980e7c2fe7dd19ac1b0336377b6fcb8010161f9101a
2280	0x0000000000000000000000000000000000000000	0xe210dd7bd99b84cd3a1fa729cb382bcabc873a49	478.68	20189033.5430025795098518	3915918	0	0x1472ff528ddb41b8688af7dedc43a26545a9b1d15609435fa48ad56b83d55151
2281	0x0000000000000000000000000000000000000000	0x01fb009d5b0648a7e4777f28552ecbc40709b41a	47.868	20189081.4110025795098518	3915918	11	0x147788a4911b2ced4a88faa2b30536525a32a015da2254bab084c2c0fec47ff7
2282	0x0000000000000000000000000000000000000000	0xc14f7ea127ad72c10f2c3bd99b2455693e736c31	477.441200094	20189558.8522026735098518	3915922	61	0xe6847c57b4f9585bc0504bbb0f32a6cfbc3f282bf77ba98663f18ca612645e86
2283	0x0000000000000000000000000000000000000000	0xc5274c39a859f4a9eb44b1827a64eb9512a27c57	478.68	20190037.5322026735098518	3915922	75	0xb0a3c41839edd02eb26ba16e22616580f03dbed3991dac4605ac6272a6408cc1
2284	0x0000000000000000000000000000000000000000	0xe06aa58eea20d165ad7d5b770abd28544ac899b6	570.96758928	20190608.4997919535098518	3915922	94	0xf7a2be394e2b9cd4051a714d3bb9c36a85ab60a7685ab86567c2ff0b7e6ade9c
2285	0x0000000000000000000000000000000000000000	0xd6200c3b8e6d9b27b87e371abc19d2c26700ec36	478.68	20191087.1797919535098518	3915925	73	0x827ca2acb1538b4e7c03bac95fd72081ee1db8dc598bb757250c4193efffa3d4
2286	0x0000000000000000000000000000000000000000	0xd84f449c80407f8f0e5bd96302709ce4318eda49	7176.763891356	20198263.9436833095098518	3915926	24	0x12927dc2f8c9b833a2b0b4dc43a7a7c589a5872dbec76febcadb518684a918db
2287	0x0000000000000000000000000000000000000000	0x82764a229a6e359e0ef476666f6842c3121a736c	478.68	20198742.6236833095098518	3915938	1	0xc9d438a5b11f7ad79dae9efa7960031ded05e3dba4d9d7345bd3da9bb22f4f2a
2288	0x0000000000000000000000000000000000000000	0x50d92deef9f715503653354064f85dc5a1b1c8c5	57.4416	20198800.0652833095098518	3915938	7	0x88c89739c75fbc8044dff9a8b10e1fb8cfddb655a44a3519e563a6653dec24d3
2289	0x0000000000000000000000000000000000000000	0x7a1e22960a76e042d2c6e6bf4976c2d2d1af1c66	5729.7996	20204529.8648833095098518	3915940	38	0x1c3dbe0f18486cb3c649613a4707c8c6558ea97f93ba2370dd6a5e9b32d9c3b8
2290	0x0000000000000000000000000000000000000000	0x50d2746a41cb13798ce5d87b93d56e8a0c5982ec	478.68	20205008.5448833095098518	3915945	13	0x6cdc8e18af30514b907ad70633e11c4490bd5c0e9c3341ccbdc77420795177b8
2291	0x0000000000000000000000000000000000000000	0xf9f1088358b4c7e7e779988476aa3d71c40e1054	938.2128	20205946.7576833095098518	3915946	11	0xd3cb447eeb02b6424ef35d42eb04cb05d495c6ef48c0fd36312f4059bc2b0de7
2292	0x0000000000000000000000000000000000000000	0xd5348b5d4ebf4a70cf77b0dc00df8c07aae7ab72	478.68	20206425.4376833095098518	3915947	21	0xa49f9cae24c86f1b383097e1ffeb0cb6842f2c3d076567f76450fae6ce70363b
2293	0x0000000000000000000000000000000000000000	0xf299d7a64a6cefa8965c008d08c733cab8c2e2c5	957.36	20207382.7976833095098518	3915952	2	0x86124ac7ae56792013a30e2aff2b08957100d9df97b4907e56ba5a96caf0a6ac
2294	0x0000000000000000000000000000000000000000	0x9df2b15985ddaeaa30c32a8e836639e588e527ec	957.36	20208340.1576833095098518	3915957	88	0x16fee3902657c4d60a671bd2068df93ebd352f7c2a630f75b4698825cd79333c
2295	0x0000000000000000000000000000000000000000	0x50d2746a41cb13798ce5d87b93d56e8a0c5982ec	478.68	20208818.8376833095098518	3915963	9	0xfb03422d156170900eeeb37ec11a1be7edc5f690604da27d770693c6483e44d0
2296	0x0000000000000000000000000000000000000000	0xb9c9b055dfde19f99bf224ca17e20a9b5e4d144e	2146.032644103	20210964.8703274125098518	3915965	83	0x4305e7c3af5a31e3a643ddca69de3af006520f0971d25c09b5d77da8035bfeeb
2297	0x0000000000000000000000000000000000000000	0x6b041adcacb8b4fbc942917efead4e14e0097ad7	1436.04	20212400.9103274125098518	3915970	91	0x62a54f917618dcb02dffa44d91dcfa4b21c73358fd520f2f06524661cec78afa
2298	0x0000000000000000000000000000000000000000	0x95d738ee4e36dca69b6d3fb70e5d9ae2a1d0b732	2872.08	20215272.9903274125098518	3915974	0	0x9de9bcb7b5c7efbe8d18b7da026c315ff056ed13929070abf64a0823c59883b0
2299	0x0000000000000000000000000000000000000000	0xb300ea13e72ba6400b8fee073482a70090a5a8e5	47.868	20215320.8583274125098518	3915984	3	0x117f37f69e26889a09de177a19057e4dd862662009c649720dcfdec66cdb6c9b
2300	0x0000000000000000000000000000000000000000	0x82e4ad6af565598e5af655c941d4d8995f9783db	6701.52	20222022.3783274125098518	3915985	1	0xb7cc4d69028be68030ea3e17f633203f233e79c6dca83422c89de5325e0e5965
2301	0x0000000000000000000000000000000000000000	0x270a1ef53981e4a6cd3b87731dd927f16ed86b50	574.416	20222596.7943274125098518	3915987	4	0xdb57c1e3e78a0441f42c5bca04c7dda10b0fd296d2497517677ce7787f9fde12
2302	0x0000000000000000000000000000000000000000	0x178b75080fa69598c02b302288b2612ed7a49fe8	382.944	20222979.7383274125098518	3915987	49	0xfd8bcd6bb600f46af28bd138298f4512c05374c93cc99cbe350991f88d7f7b96
2303	0x0000000000000000000000000000000000000000	0x424c0d3440043b743159d57640d2d05295a1e8db	239.34	20223219.0783274125098518	3915990	15	0x65671281e27387bf9d28bcabddb6940018601013a0bf146a118709b9e032f7a2
2304	0x0000000000000000000000000000000000000000	0x0079528cd77cb2cee098141db633be9fa7353cdf	382.944	20223602.0223274125098518	3915992	21	0x267ec3481a3b2c511ba5eb2db0f8220d3f5c3e68e7941b07283b05b2fc69823b
2305	0x0000000000000000000000000000000000000000	0xc6e8fd345b46d9c3a6ad0ea2fcfb0d255e73539a	1457.0259702378	20225059.0482976503098518	3915993	0	0x4d127bb886c67e960a5a80600bbcbf7b9db712e79b26c74ddfe260f083e5f7a9
2306	0x0000000000000000000000000000000000000000	0x4544451c39b3ca161ec5662e12a97aeec4ab753c	2393.4	20227452.4482976503098518	3915993	9	0x6d62157423385fa341a9d18c9bb88e57fe768a444816a85f62e5f092572ee09e
2307	0x0000000000000000000000000000000000000000	0x2c050cd43fb3e5a5f066f6132ebd41a6d1ef3374	86.1624	20227538.6106976503098518	3915995	17	0x5200eb25be35fc3833f908c7354844406f5aaabd42a8f1b546fe594f4393219d
2308	0x0000000000000000000000000000000000000000	0x4544451c39b3ca161ec5662e12a97aeec4ab753c	813.756	20228352.3666976503098518	3915995	19	0x6a4ddb200fb124a2b642b0b7749fa66db54619cc1a4fcd5f7b701b8aa13e1015
2309	0x0000000000000000000000000000000000000000	0x63bf7458572e6014027794cd1b688f9c579fffec	12.44568	20228364.8123776503098518	3916005	11	0xda4353065dc7a989e65b7351f48cc82f47661d29f8bb837f4f4eb8a491822c6d
2310	0x0000000000000000000000000000000000000000	0x60d77ef89e7267c667d7cf27bd6cd56d7212eba0	239.34	20228604.1523776503098518	3916005	13	0x50c0e3d4d644a15e5d6d6b0aa6aa496b22e7e361e4b61364c15892e1547db61c
2311	0x0000000000000000000000000000000000000000	0xd53790a6ba5f84bc6724d55a90668b95a38eacdc	9.5736	20228613.7259776503098518	3916017	22	0xb890cf4092b72f8794900f8254dbb26b650afa2369161ef50a768e9f08f2d44b
2312	0x0000000000000000000000000000000000000000	0x3b564f1eaed7968c86433ad155b9b2e1cca0e9cd	201.0456	20228814.7715776503098518	3916020	51	0xab8b55c13b556beb8c3cdf5bd0492b22a2ea186470e8c46fafd4043f77e1af1a
2313	0x0000000000000000000000000000000000000000	0xf49f8154adf80149073cc12e4c90b6289d1615e8	1436.04	20230250.8115776503098518	3916020	59	0xe93f285dc008b169567a53cab1213dbe950f2b0ddfd6c418e41e0a04ca681470
2314	0x0000000000000000000000000000000000000000	0xe6afe8962d890ac9db64c3af408719681840307e	119.67	20230370.4815776503098518	3916020	67	0x0f7f5c4cfdc9f2ba264644afba0336252cf1430b3ec1251deaf39306c2528761
2315	0x0000000000000000000000000000000000000000	0xb3393e6991ccf120bf7d83e6e53aa6ac8ac5c551	732.483603408	20231102.9651810583098518	3916024	5	0x3d7259b7ea2c5880c877f224b96ff43677b178f772ab42d424cf6ea5e008c9a2
2316	0x0000000000000000000000000000000000000000	0x002bd795cf3f28f8ef503d5283facc8e168d0066	57.876612711672000755	20231160.841793769981852555	3916024	21	0x06695d2e4aabea895965fb017246570bfe1a299700d4555f0c5921af2565afd2
2317	0x0000000000000000000000000000000000000000	0x4544451c39b3ca161ec5662e12a97aeec4ab753c	2393.4	20233554.241793769981852555	3916024	25	0xa54aea40e210796328c02b066534fb654814e21a9bccf22622b86b02c4642215
2318	0x0000000000000000000000000000000000000000	0xfa187b6c8a6d8e9e8ceda5bf0a4a705148ee44f3	2393.4	20235947.641793769981852555	3916025	57	0x4392c4d6e61d2dc9072af3c34bdeb737f26d5873b7e5f83569733ca9c377c815
2319	0x0000000000000000000000000000000000000000	0x4456854c7b9531ba763d28d35c8f93a6b19bd70a	335.076	20236282.717793769981852555	3916034	34	0x86bebc11d48fdaa1ed872f90d3cd184e097fa00a54a574fed965c44b5208488d
2320	0x0000000000000000000000000000000000000000	0xf033e90fa312fd7e40f1a0d67a42f18fc5d97c79	1914.72	20238197.437793769981852555	3916041	33	0x829d6a52e7f275caed7074d206d79143d696d23c6af51ae2f0d685ea7bec689e
2321	0x0000000000000000000000000000000000000000	0xc3f4e37f0f20430a00be51db099aef6234c879a2	191.472	20238388.909793769981852555	3916073	64	0x751a3cc5244375a957e2167f1f8723d2c54172a4a08d793b2322429c477e7c5f
2322	0x0000000000000000000000000000000000000000	0x01432e5f78ec7054c0fa58c3893827a69f0cfb26	196.2588	20238585.168593769981852555	3916075	12	0x39d42085e3a155d27f5e3ee9e086eaeb811fe620bfecf5e2e7219fde1de21f2f
2323	0x0000000000000000000000000000000000000000	0x40a4bacf8bee7e0804730defab21dada47942d7e	47.868	20238633.036593769981852555	3916077	65	0xd3ce42a99d2df8313ae3dc13997b7bf65eed46c38f5dbdee1364d9292f46287b
2324	0x0000000000000000000000000000000000000000	0x27424c184602f0fbb80ba5e89d06555eee062b36	239.34	20238872.376593769981852555	3916082	32	0x4e270a43648db890f486d9ea47b73c7ce243765e965143b2487155bbf42aa0b3
2325	0x0000000000000000000000000000000000000000	0x0b5aa00253a21c66c479b9092c752e3739d5b618	516.9744	20239389.350993769981852555	3916087	0	0xf939f7c2d93a478e26b2e738a12fb0d582d87247c77c0407244b4cf0bf638c82
2326	0x0000000000000000000000000000000000000000	0x013f4cb596407e9becea6b093d45d5874b77c178	178.016985514944001511	20239567.367979284925854066	3916094	46	0xd2bd8ee3bbf0973aea5f4c0e0805c8a55374b4959f27ac4dce8e47daccbce7b6
2327	0x0000000000000000000000000000000000000000	0xf06498ba539493a371e1b4a133861cde7c0e1777	957.36	20240524.727979284925854066	3916094	74	0x622da24cdab09806f25ab6a39380f2ee06abdfdc7a4f02d0514a3ee2652d3666
2328	0x0000000000000000000000000000000000000000	0xdbeb55d8ef9a196f48b6340a14b90ef792ae5b9c	957.36	20241482.087979284925854066	3916096	10	0x74d625d01474850937876adfbbb6c73f80a3d06eba57e1395405b8596d38b67c
2329	0x0000000000000000000000000000000000000000	0xae47b0465e954e67aaedb598267482c1f1ed828d	2393.4	20243875.487979284925854066	3916110	37	0x566c39396db81350854e0344a635d71432434c9c20b8c3a4f5480dc84e7d1370
2330	0x0000000000000000000000000000000000000000	0x56f5085aa40d9ba4f7d28bd5e9a006246616f523	1148.832	20245024.319979284925854066	3916112	21	0xab71f891391e264bba1d90f9b4b0c87dabc2ff81d13dfe3514400c35bc1c1a8c
2331	0x0000000000000000000000000000000000000000	0xe529e2f92c6d82fdd25f0276edc44d5ee536a2ea	229.7664	20245254.086379284925854066	3916113	34	0xa7484936a75450fc653c924daa7c9f884842e2bf1aadfac336bc376691e31348
2332	0x0000000000000000000000000000000000000000	0xaf42fe25c01a76bdf4bd6fb589ac4a1e2677edf4	478.68	20245732.766379284925854066	3916128	10	0x4485cec91f384336bfa0cfea8837101b14865d4e2bd6f6c8b5b2ea75cc350eeb
2333	0x0000000000000000000000000000000000000000	0x25af88fb595ec3b94d7803a58c92a6ff8b5c26ca	473.8932	20246206.659579284925854066	3916129	19	0x350ccfe09bede2ceccda2e9200d503961b7744c10537b929defe4775a5bc926d
2334	0x0000000000000000000000000000000000000000	0xf3f76c078553702af433fe9d9a8ac9ca4a209924	478.68	20246685.339579284925854066	3916132	35	0xab05a820550e6c748cfdf45e274c53e6531e5832b985b086d11c17c32ae78aa7
2335	0x0000000000000000000000000000000000000000	0x4271bac2d4d7d5c0f616b43f1d77e5c46d40cde7	57.4416	20246742.781179284925854066	3916135	42	0xaece8de9345c80f1d9a06c0d524a534a78a89f5bd3b070d28947908d90f09a5f
2336	0x0000000000000000000000000000000000000000	0x83553d5b46f462f71850072c9d8ee931ef02004d	861.624	20247604.405179284925854066	3916143	16	0xfe099543e0d2e31e54a37b0aa6e1ef958998d85b34bdc2d2296ccf54184bf7e3
2337	0x0000000000000000000000000000000000000000	0x11a0d491147b1e525c518454676e5415d2b66f29	478.68	20248083.085179284925854066	3916155	62	0x5f14f590da9702cf3a9e1b821a0de484ec05c99e64182a9dacb3ff7f03a27313
2338	0x0000000000000000000000000000000000000000	0x8893daed6e072c4c3cb50d1b7947547a56bb2c19	1914.72	20249997.805179284925854066	3916194	0	0x7e654d742fc3627909ef4469c56f7396d6d97946a864ad5642a56d6737954927
2339	0x0000000000000000000000000000000000000000	0x7f4823876318fad7321fd813b7abd4a7c60c12a5	1982.634256776	20251980.439436060925854066	3916200	8	0xaeb6d4347957568f606d806b9c7c593702f54b740d71d9a19645692acabd7333
2340	0x0000000000000000000000000000000000000000	0x0f134d75a12613ef9afaa700f43f52eae658cc88	38.2944	20252018.733836060925854066	3916204	0	0xaeef8967c9e5ba590161b868e6ac6358000ecaa67a19691199676742dadba766
2341	0x0000000000000000000000000000000000000000	0x25dec53065acf6bf7466c726488c2c0e3e4a8193	2393.4	20254412.133836060925854066	3916213	50	0xfe2f49b5e787b94a5ded7dc52ee54258578944e9a15460310264d679aea8a056
2342	0x0000000000000000000000000000000000000000	0x0d275e4e58ce5f60b31788403cb9e3214c9d00ac	1436.04	20255848.173836060925854066	3916224	0	0xedfaeeba076b8f59b9a443e091a6c0ac169c30ec420be76e721f68f49c390763
2343	0x0000000000000000000000000000000000000000	0x3df4bf72f299463e183f4977ea2b5b29ba7dda94	143.604	20255991.777836060925854066	3916260	29	0x0f91812af678fdf187ee0fab8295865246e829b70d3131806906c1cf362d2a43
2344	0x0000000000000000000000000000000000000000	0xc5e48370a36e69d700e2e8250ba290213f3b3f8f	348.431172	20256340.209008060925854066	3916266	95	0xf4d768cd7d78925771cbd1425799313c2f5ebb413fa64a75ea46591d1ff9dcfd
2345	0x0000000000000000000000000000000000000000	0x4be205af8b2609afebd65dedda6c3c6b0de21bae	478.68	20256818.889008060925854066	3916267	3	0x3a0a3c60b77db0147fa14543ea8d0d2f925da98c25953ca24a61361585948d5a
2346	0x0000000000000000000000000000000000000000	0x63db17d372c1e6ad23f49bf7b2993cc8af482e91	957.36	20257776.249008060925854066	3916272	28	0xca7368e74957d9eac86a7d32058fa3e2883c45c17321dde5422ba9509f1d4954
2347	0x0000000000000000000000000000000000000000	0x0da8b8ba342526c661bc04d64420d7f224e16df8	718.02	20258494.269008060925854066	3916275	4	0xdf8dbf1210f1651e7af256f15df5ed8d306da9a87ae4055380545e724e5ee736
2348	0x0000000000000000000000000000000000000000	0xfacc4b6a24966a2056bc52f7fc720dcce45f4346	246.088478508	20258740.357486568925854066	3916278	2	0xc7012b5b83620ea777a8f8b43765357be8dd138006e047f922a201f169bc8d28
2349	0x0000000000000000000000000000000000000000	0xb8e82d4f528163c3f3a6b349eef6deaa53d8a0a4	11.00964	20258751.367126568925854066	3916294	82	0xa23a10c926d38b976f3ba236e0f882700f605e95fa422f70d378e0f508d04a02
2350	0x0000000000000000000000000000000000000000	0x433f83d213b14d2d9914fdca39ab21c5cdcee5bb	947.7864	20259699.153526568925854066	3916308	75	0x55b8d16376f32811c3599c2c64074b510d35ff970a5f6feb12aeecb98333e5de
2351	0x0000000000000000000000000000000000000000	0x0da8b8ba342526c661bc04d64420d7f224e16df8	138.8172	20259837.970726568925854066	3916313	9	0x03d9210108b797979af12f7312e1ac8e833b3ffd8839ae39cc8dfddde1b708bd
2352	0x0000000000000000000000000000000000000000	0x433f83d213b14d2d9914fdca39ab21c5cdcee5bb	9.5736	20259847.544326568925854066	3916313	65	0x5e76d371412309a867202161d5c9dcf7a892bed75ae9393e79115070fb22012e
2353	0x0000000000000000000000000000000000000000	0xbd74bfbc361b6e9ad1b26e1ab62f1fd38c62ec98	1914.72	20261762.264326568925854066	3916313	66	0x69f2f8b21da9f6dd888aca8b8b5123dc23534b268c6fe300e894463550a1637b
2354	0x0000000000000000000000000000000000000000	0xabff30dccd2db83435621e26f3203f327a829952	246.57643341168	20262008.840759980605854066	3916320	7	0xe5c83126ac2a18304aa859af4628a5c3bcd9add588bbd5da427af78091f4a0d8
2355	0x0000000000000000000000000000000000000000	0x590708fb8d21eb1265b4fbda348502c35f44a4c2	10530.96	20272539.800759980605854066	3916324	110	0xe215da5d29a4a2ba2188e893c37cf5398226828196fc38888976fd84aa95b926
2356	0x0000000000000000000000000000000000000000	0x4bd57642cfa87b46493f080df7b834ab2be7159e	1902.0328163664	20274441.833576347005854066	3916326	51	0x0906c3cb1efa2bde8851796139458c9a8d197ac12b55164c3aa359db58543d82
2357	0x0000000000000000000000000000000000000000	0x235d6e2d599df935da847b5662443653957d14a1	8.61624	20274450.449816347005854066	3916328	13	0x445b7d691713a7d5ad9aefbb0266adfbefc69c192518c23457df7fb35c85d455
2358	0x0000000000000000000000000000000000000000	0xf3f76c078553702af433fe9d9a8ac9ca4a209924	478.68	20274929.129816347005854066	3916332	95	0x0382648b75a13d5697d72ec2e3778c63b10531fe8d2ab66ffed3ec285ce39251
2359	0x0000000000000000000000000000000000000000	0xb8e82d4f528163c3f3a6b349eef6deaa53d8a0a4	101.95884	20275031.088656347005854066	3916333	126	0x70b6f3be1fd747f2dd9754682db525ca19c96b6c7bc19fd2c3138412033c87ff
2360	0x0000000000000000000000000000000000000000	0xe58193ca76063feccb0fd70d2bb0c66cc4d38528	38.2944	20275069.383056347005854066	3916334	38	0xadde8e87438eb0246f3edfe13da7e187252df3fd30ceccc476c0a2b20a3f9991
2361	0x0000000000000000000000000000000000000000	0x5e46be17e9dbadca7c7289e9074c5a926f70e958	478.68	20275548.063056347005854066	3916336	19	0xc0b1991aa94e79096d9456079699ae5e36481317021c33904e653f2596bb0cde
2362	0x0000000000000000000000000000000000000000	0x1be4dec6faf3a4a54632a103f55cce18afa4dd0b	806.09712	20276354.160176347005854066	3916338	31	0x6eba9188fa513758055aa2eef932035618881563c8940b1eafa6e88e444a7d06
2363	0x0000000000000000000000000000000000000000	0xf84826cf2d1d99701fcc917da09d478c8032a1de	47.868	20276402.028176347005854066	3916348	17	0x3bede6ff8e85790d91b4ed5b95aa978e7b4bdc230309410a27badafc94df2887
2364	0x0000000000000000000000000000000000000000	0xbb76da4426b73f2797192b7318ddb07ab1b95a47	1005.228	20277407.256176347005854066	3916348	38	0x2602bcbaa6d73d757f06800edc3a3d3ae17f0839bd39953e4b3cad375533507e
2365	0x0000000000000000000000000000000000000000	0xe61c8a2ed1ffc0e682f0f3de7839f11b487bed7f	478.68	20277885.936176347005854066	3916348	65	0xacdcaea5fce0557cf6ef6ace5b2c7ec88e071e6961cb56c21f2dda4e8d05733d
2366	0x0000000000000000000000000000000000000000	0x783e43ef8792a39ec3bfe5c2985db9975f159282	395.38968	20278281.325856347005854066	3916359	20	0x40a9f368d825797b6f6f02e8cb395183fa5f29b85b238bbf9f11bc56061fe77b
2367	0x0000000000000000000000000000000000000000	0x085b3f4523a53642811bb1ef19b3748f709f3b98	4.7868	20278286.112656347005854066	3916380	85	0xfbd37e7add03f35b033ce374446dcb6fec34a5aadc46f4d53c0181ae821dd179
2368	0x0000000000000000000000000000000000000000	0xa0f23d0ea8bbac77006c6e18d85d17cf7d1fe824	707.48904	20278993.601696347005854066	3916382	1	0x984e84da287485851a673fdf203c7fe4d9d8fee0498cfd5aa87db7530ccd083e
2369	0x0000000000000000000000000000000000000000	0x085b3f4523a53642811bb1ef19b3748f709f3b98	47.868	20279041.469696347005854066	3916399	48	0x8ea940b8fd537f6218c62aee877460db3f72375ebda1d0c050966ba269a742af
2370	0x0000000000000000000000000000000000000000	0xb27f74b2235fa161aebf4d910d9fe22ccd53b1d7	471.97848	20279513.448176347005854066	3916403	13	0xb7caa4e095298303158e990d0a6e9bd751a530077cb0f7ffa243ae44c9871d61
2371	0x0000000000000000000000000000000000000000	0x085b3f4523a53642811bb1ef19b3748f709f3b98	683.76431363052	20280197.212489977525854066	3916404	46	0x2f44a3ca74f37af9c04cfb925bc8f336a47cca50944992c15c27bfff904fc3fa
2372	0x0000000000000000000000000000000000000000	0x1e8ac273163f6f7bcefdc7983a357714eea853ff	203.439	20280400.651489977525854066	3916406	7	0x51ea12371510f512ded9a5fe83cd2a30c4ccacda63a26c26071116004fca8676
2373	0x0000000000000000000000000000000000000000	0x203dfed20e49ff4834f1cad58c81cb7093032882	478.68	20280879.331489977525854066	3916407	80	0x5001890eb0ee2a9d299ecc163d0f5db7132456216464bcdb4e587228b0f1fe60
2374	0x0000000000000000000000000000000000000000	0xf9a39bf20f8b0b13dd976b96b04c4709147ca9c3	377.118572103	20281256.450062080525854066	3916422	95	0x7a6fa5ffd49c86e4f41d5374210783f73fd07b12236112627ebdb35faa0383ae
2375	0x0000000000000000000000000000000000000000	0xb996b0b6ca1de6520dd7a37cd551d130fe956654	957.36	20282213.810062080525854066	3916427	47	0x6cab9c19cc2db5a32ebb44960aef6349b4cbf87be77738f5e5b0d2d4bf882cf2
2376	0x0000000000000000000000000000000000000000	0xb27f74b2235fa161aebf4d910d9fe22ccd53b1d7	467.19168	20282681.001742080525854066	3916432	26	0x0d60015c65ac80c1b5ff1e3c01c04be037ee6bf00a8ff0d2c111ab92b997cd76
2377	0x0000000000000000000000000000000000000000	0x3254911960fde450cb2d434c1892f34ce473982a	981.294	20283662.295742080525854066	3916437	93	0xd4c32173ff913d0e871889a32e4b427bad1dd27305277fe0ebb9b2ba8dccf0bb
2378	0x0000000000000000000000000000000000000000	0x711dda678abe166ffb3dcd1a18f1280e3d5d07ae	478.68	20284140.975742080525854066	3916438	1	0xce3177596e1704dfab96fd2d08a3a566addbe08f1a51211e99839f7ef160b1bd
2379	0x0000000000000000000000000000000000000000	0x80f6cb68238122dd8c957a48de45264173f2d6cf	526.548	20284667.523742080525854066	3916439	61	0xd2f2acc31a0dc9a908065561b5824abdefba8f758ad5c4fb9de1989c2b35848e
2380	0x0000000000000000000000000000000000000000	0x711dda678abe166ffb3dcd1a18f1280e3d5d07ae	957.36	20285624.883742080525854066	3916448	13	0xd78d6b1b7d5ae733c1a8788fca79351e2a258b9407503c65fd24d8759c2a992e
2381	0x0000000000000000000000000000000000000000	0x6e1585214366bdd21188fc8238323f6b20637035	478.68	20286103.563742080525854066	3916454	17	0x93367b013c7fabcba9ff40be762a8489d24446ddf8718ee9e66303c61133f797
2382	0x0000000000000000000000000000000000000000	0x44e83779bdc14ddfdec960bfc48530c45ec51d17	861.624	20286965.187742080525854066	3916470	3	0x03a4eea8c6a6f0312d0a4975b1de6607962c10e0b249f30bbaa6cff632a8dfb3
2383	0x0000000000000000000000000000000000000000	0xcee198dd1e4482735ee4013dec978a8c6f9ddb9f	143.604	20287108.791742080525854066	3916506	40	0x51669aa79a413c8448e0fa8049a25a1101f117639c9d7bc6717f70173bbb333d
2384	0x0000000000000000000000000000000000000000	0x05f962aeb4facbd8d580a7e0411f9093e06668fa	478.68	20287587.471742080525854066	3916510	2	0xd0697b0bb77f936ce616b411aa097f3cb299627974cc9ede19561902406c8fba
2385	0x0000000000000000000000000000000000000000	0xc7a4d1210ae0521605ec253bf7b925dd6235b443	1043.5224	20288630.994142080525854066	3916511	43	0x5f1b5a18ee804b4cd912f1a197f7511072078ad96df00cc80fb86a05e6edda51
2386	0x0000000000000000000000000000000000000000	0x343d598bc565328f4c39ffbd955241617ed665e7	47.868	20288678.862142080525854066	3916516	96	0xd0c93d4d82d083f4b8def000948583ac0cde53605b0f1120cea7e97d2107ac0d
2387	0x0000000000000000000000000000000000000000	0x085b3f4523a53642811bb1ef19b3748f709f3b98	261.4799695884	20288940.342111668925854066	3916519	23	0xba4ce6a2923f3ce47bd4693ea37b164f3504363da6898f47c51fe199638d7211
2388	0x0000000000000000000000000000000000000000	0x2b2192086ee41b6d36922cc4fc0c8ffc567dbe67	2393.4	20291333.742111668925854066	3916523	1	0xa7956275b0d8bdaf7eea7ff9c7022e732c37bce1593465dce21a6ac26bb1a62c
2389	0x0000000000000000000000000000000000000000	0x001a5052aff8190dc67cfb6b10daca2c4a473c71	4786.8	20296120.542111668925854066	3916537	2	0xe311046d312381397643f215110de6b20764f364972c0c255a8d811f67136c54
2390	0x0000000000000000000000000000000000000000	0x27b24e69918c5a9636bee45d6313dd22f406f873	2393.4	20298513.942111668925854066	3916538	0	0x885a23b82328313a988ccc0f03f1fa6da8d98931de69f3a71559869904f2aa6c
2391	0x0000000000000000000000000000000000000000	0xe2ee03992377209a6236cd1f35f6d736315d743c	191.472	20298705.414111668925854066	3916544	96	0xe80a0043abea8274f929141cc248756184d654b0ec520d920ebea3ac5b766e7f
2392	0x0000000000000000000000000000000000000000	0x244148f142853d955784c90ac1e0f74703c11fa1	239.34	20298944.754111668925854066	3916581	107	0x758ac3d2b90369196198f6e741e08a87e6eb8a20aebbf31877771a3fec700d1b
2393	0x0000000000000000000000000000000000000000	0xa705772f6ea6bddd37edcff3eceaccf32f8f5aa2	478.68	20299423.434111668925854066	3916588	39	0x09705290275554aeba5907b5017ccf32f5e86e30e5f1c62d67eb6f371e55a7a6
2394	0x0000000000000000000000000000000000000000	0x114e3f56dc50c4c97e6dc43b9617687ef32b0791	33.5076	20299456.941711668925854066	3916596	123	0x14f22d97489b646fdf0c85967e387ba625d762ee33167eabec4fa4888cd4dc20
2395	0x0000000000000000000000000000000000000000	0xe0e486f59e6a5a82e4de63995f2160acde6026ee	957.36	20300414.301711668925854066	3916597	50	0xb7b82d4dd93ab7164c686021f555c2d50d3886cbadc7a711e9230941637ad7a7
2396	0x0000000000000000000000000000000000000000	0x07ba5c44575a30e39a138a74a4d3b74ebb460a9f	239.34	20300653.641711668925854066	3916599	12	0x3793c161894903eb818a2b40dab9406eabd643b79d3b504465b78925ed27352d
2397	0x0000000000000000000000000000000000000000	0xb6aac3b56ff818496b747ea57fcbe42a9aae6218	574.416	20301228.057711668925854066	3916603	16	0xf88713b0d17917263cb4a7a56d4e03fb08b685b3df9b034fae299a3444e5fc6e
2398	0x0000000000000000000000000000000000000000	0x09b8b644fbfc6ee8e5dd0f450a030e5f381a5cfa	238855.998212896286901411	20540084.055924565212755477	3916604	61	0x91626111211273e1216d80e4e19a895e88eb26e536d6846a66775923d5e8e31f
2399	0x0000000000000000000000000000000000000000	0xd1fa069653b2800c5f0ac4829fa7ae14d4b87198	4786.8	20544870.855924565212755477	3916604	66	0x84a41fb6b14e53ab88bd61e1c1e885da9c4a2950e83366cca950660579bdfdef
2400	0x0000000000000000000000000000000000000000	0x2d9836904430a15dae1922548c6f0af1ae9b6cd8	47.868	20544918.723924565212755477	3916609	5	0x76e9a7365c56f3a9f80ab342df1192fefbafeb0922b1ea33ca9c443f7d1ca482
2401	0x0000000000000000000000000000000000000000	0x1c9e16ed9504fe88b09ee1b94e73a108275e1980	3350.76	20548269.483924565212755477	3916609	109	0xe328bf2c228863ca1190be2be9a2db030fd6cabf4ad821f4c1314b3eb745e316
2402	0x0000000000000000000000000000000000000000	0xb0be566c135084b48438effb09c4108a8c402ed8	957.36	20549226.843924565212755477	3916611	12	0x5e2871e2f63c6021c98edbc4b973386a3add466a4a5d26c618f335092bcaf380
2403	0x0000000000000000000000000000000000000000	0xd2f4def61791810736ff401f5453f57d29cad29b	14360.4	20563587.243924565212755477	3916615	6	0xaef621b9548eca86c61312da2b3036f32490584da5fca24140cda6afd27fc8a7
2404	0x0000000000000000000000000000000000000000	0xd163706738a37344e0d040548397b94852a37b26	628.02816	20564215.272084565212755477	3916621	56	0x21c1688ec4c341ca0f99d8bc127e3ecf751d83df3b99755bd9cb8f8780ef9be2
2405	0x0000000000000000000000000000000000000000	0xc33537f81f118d57ced167e2e4de7973da5dccf3	957.36	20565172.632084565212755477	3916621	110	0x9e2f5a5eb9fee70af40f650e9ad29f59d4f7f6c91da30a930c6ac01a1d3a0d65
2406	0x0000000000000000000000000000000000000000	0xd1fa069653b2800c5f0ac4829fa7ae14d4b87198	67972.56	20633145.192084565212755477	3916625	57	0x19652ba83b4835de043a5f97a3ae048812255f8f36e60482eedcae021a26a8ce
2407	0x0000000000000000000000000000000000000000	0xd93a8706fac801cbc7e03025c082e6484accbbae	4786.8	20637931.992084565212755477	3916627	6	0xae61f9832f9732ea1bd958ae705215649f55dd583193178099a43dcdec4db0d4
2408	0x0000000000000000000000000000000000000000	0x2d9836904430a15dae1922548c6f0af1ae9b6cd8	191.472	20638123.464084565212755477	3916640	7	0x25e8aefd344e3cfb8c8e9896085a97a12e14ee71cc5d78c2f54784e283734421
2409	0x0000000000000000000000000000000000000000	0x40a5902a54d206192fe3dd8055e97c3171325432	478.68	20638602.144084565212755477	3916640	8	0xe0d116e956cede7f370ca720b2b30c4108c39207e135339aeafe5e862592cec9
2410	0x0000000000000000000000000000000000000000	0x40d1cb3e3f5224075970de8b9ed1d252497ee448	22.01928	20638624.163364565212755477	3916640	121	0xb7a859a0ace8e5d96eec92348ebdb4c4e4e9cbf43d4b61326a8699f3614bca1a
2411	0x0000000000000000000000000000000000000000	0x75172305fd86fe9b91a70f084c01f51212126eba	245.036292	20638869.199656565212755477	3916642	76	0xe20d08729e3e70336e1e0cc495ce692298019d051050abb71f335838c1982ead
2412	0x0000000000000000000000000000000000000000	0xb3cf70cc8745fe939ba393742262a9ac0dc3ec39	2265.496704	20641134.696360565212755477	3916647	114	0xf3d1acbe45ee04e1053bbf472bd63e99adf26b71ad15f520eaa256528748390b
2413	0x0000000000000000000000000000000000000000	0x4b731186739844a761f09c6d2a4a89ad28623e5c	478.68	20641613.376360565212755477	3916658	10	0xc8d438fafdd6bd74a098ff2d64f318d94a4a6e2bd96c39f96e8f3dca85b4bd4c
2414	0x0000000000000000000000000000000000000000	0x2a83f53abb49fa7df4e7cca4630b2cabda5ac15b	473.8932	20642087.269560565212755477	3916672	8	0x2e56805eb269a21b060b88b472bb7c27a081429eb35e69f1999f5de6ef2f5e18
2415	0x0000000000000000000000000000000000000000	0xe9500755ebea975c690f90b794bc763eb60c4881	957.36	20643044.629560565212755477	3916678	70	0x9227951a4c23a29444fa014eccf20f05cd6c4ef801ae9a6dc2ad7372b582d863
2416	0x0000000000000000000000000000000000000000	0x489b88d42628fcae059018d47aa9dba420c9abd2	1483.908	20644528.537560565212755477	3916681	1	0x50aeb975447b406d52479a94a6bbb5818124702402163761006fff5d08910c0a
2417	0x0000000000000000000000000000000000000000	0x2e1a17bd8cf6d9c809776a8dfeaa6a2abbcce99b	38.163170099904703284	20644566.700730665117458761	3916690	5	0x8283f7d7f069bcc43a268698b2a323b3faaf7b981783035193a6665d1d0aeb16
2418	0x0000000000000000000000000000000000000000	0xfef808fb5d36d560e42f50e6e8dbaf671123bfc4	215.406	20644782.106730665117458761	3916691	81	0x97bab470dbd82af349d8d55f5097b34efbdc5595e91efeafd2064719be037fc4
2419	0x0000000000000000000000000000000000000000	0xd8c6060d4cbb5273bedc2df3aec7f598cd7c0a31	149.443896	20644931.550626665117458761	3916694	11	0x8c69e91f62fcaaeb0fd56f46b5a69b7b286c3b59569b3a664a17aaa5feb6047c
2420	0x0000000000000000000000000000000000000000	0xd32ad1b1906f213d2df839d0511cad18efa65401	765.888	20645697.438626665117458761	3916705	15	0x8c1d84fb18ed810a02474ba0da56c785e96d7f792c0410fdfd20e033178cd5b0
2421	0x0000000000000000000000000000000000000000	0xc539ef373b2663e2cd7f95073fec71cd6226c75f	2.680608	20645700.119234665117458761	3916707	30	0x2ffc30a1c372e9a1eb5280f66be37a08fe587db319e5d1605350625b7ab249e0
2422	0x0000000000000000000000000000000000000000	0xc1d0b8c3a5a76f1aff188d5296f1f610872229cc	909.492	20646609.611234665117458761	3916727	105	0xedab75d14c600cf80744aae1a8052ebdaa4774b709d3622bd5dfedcc19f29a49
2423	0x0000000000000000000000000000000000000000	0xe20e532c4ba934bb1d145480d38017cedd78c133	47.868	20646657.479234665117458761	3916735	9	0x9e17770d253313da8351dd1d7ca8fe52a02bea5f6cae4652ef89f930110ba846
2424	0x0000000000000000000000000000000000000000	0x696dce52ca0a520dd9e4e3137d77a4ad386f00a0	478.68	20647136.159234665117458761	3916738	131	0x4a2196e323bb5f0a5e361398bb73d4257248ec8c240cb2288d4a794a747f3714
2425	0x0000000000000000000000000000000000000000	0xc539ef373b2663e2cd7f95073fec71cd6226c75f	2.3934	20647138.552634665117458761	3916755	81	0x435f854fdcf398dfacde33d2d623abe2568d4c803f0fab02084af804dabbfa75
2426	0x0000000000000000000000000000000000000000	0x760739f49fc2936a59745644a94a5400c62a4b22	2393.4	20649531.952634665117458761	3916764	12	0x8222b9502015f97ac67a02af41601893749c2c4e8e01f5400ce5c1909187a2d2
2427	0x0000000000000000000000000000000000000000	0x03c46417bf0a78295abbc618721b186a099afc42	239.34	20649771.292634665117458761	3916764	116	0x9f30cf2954c7530a8e6a1b7ce9ff49b6a3a5b7f28e89a482d4d6b0bb8a2d93c2
2428	0x0000000000000000000000000000000000000000	0x4b731186739844a761f09c6d2a4a89ad28623e5c	574.416	20650345.708634665117458761	3916772	6	0xe9dd831f46f44567024fb55d35fe83585cc80e15da576a722182615b0f91c255
2429	0x0000000000000000000000000000000000000000	0xe8ddee82e2ee2661c6adf11faa6c99555e301dc0	239.34	20650585.048634665117458761	3916773	38	0xe29ebbff68931cc261c31893d105e0f8bdf2c59db6119373d449c58a278b19b4
2430	0x0000000000000000000000000000000000000000	0x841c223d5f95a44e03d0b97683792399cf830d1c	519.3678	20651104.416434665117458761	3916776	30	0x410edfc0a403ada67259876fdaf01bcf8b7539b4ba970430c9d60a44b5e8c274
2431	0x0000000000000000000000000000000000000000	0xf5fd0e65ba30a5ee0f307fe6251495d2b34a7c6a	478.68	20651583.096434665117458761	3916781	36	0x0a177c4f6e5741d48246931b40b092aadd5f7caf3a7ae22a3f8007a0f140c558
2432	0x0000000000000000000000000000000000000000	0x7b54b5cac5a72d90c4772ea21e31fac8844f03cd	109.9194846588	20651693.015919323917458761	3916781	81	0xace96f28c5d82d35583c7559d15eda74649a303f972c30ac7f059aca100dd0be
2433	0x0000000000000000000000000000000000000000	0x620348621ce092ee666b698246491e95c8e61499	478.68	20652171.695919323917458761	3916792	32	0x73a719140da123d4d1ef0fbc0d8cde9cc7745f72efb1f189f3d1e08d72e1adaa
2434	0x0000000000000000000000000000000000000000	0x04605a6657f1cd074ef0cbc684af8f0f24cfc7a0	479.15868	20652650.854599323917458761	3916796	24	0x4afa0c9a2386e21348306e2d6cf5dae1f8a2f04a9f26483e4ed509880bd81a9f
2435	0x0000000000000000000000000000000000000000	0x46a0abd4764d27b050ef6b5168f2f46ece7e3e42	47.868	20652698.722599323917458761	3916796	37	0xfc62c26c837056543c659f1d5bdb4c5062a3c76dcbe90387af95fc0ef81a19d0
2436	0x0000000000000000000000000000000000000000	0xe616f2749253beff764136e148a083a597c489cc	16753.8	20669452.522599323917458761	3916803	10	0x7667d9f0156a4e2fc2292b99317197ba90004119902e62d874fb2605c86dd081
2437	0x0000000000000000000000000000000000000000	0xa193c943980a9340f306b3d59deb183dc501b35f	9.5736	20669462.096199323917458761	3916818	1	0x908da85aff70942127f8c99493ab90fc144b9f00412745c90297072449d0fd63
2438	0x0000000000000000000000000000000000000000	0x1eb060c6d51611a13956649b73010402c5af56ef	957.36	20670419.456199323917458761	3916818	26	0xcfc13da2b641e398d51030d4e5c2833be3e2f8d7852b100bb784da588131d482
2439	0x0000000000000000000000000000000000000000	0xf7dfdfcaa55e0e2123d7302cb4144ee9ca521e1e	100.5228	20670519.978999323917458761	3916818	49	0x9f9aecff2d5f341eb5adb2c560a2b4452ce196f4df369564b4bd66a81d608723
2440	0x0000000000000000000000000000000000000000	0x8def7f7230f0e40df2efae846ac92eed7084ea25	2872.08	20673392.058999323917458761	3916819	13	0x92ab8c92d290dc37c39fa94e887fd488acd57f690fc6ab1b09d1445d68c8c011
2441	0x0000000000000000000000000000000000000000	0x28d1d0f1507e26ce3248a79ff05638d98cc5111c	478.68	20673870.738999323917458761	3916819	44	0x73ae52c41c929de66507d4ff93dc79cc88ede56cd9b06681a057abb7efc6220d
2442	0x0000000000000000000000000000000000000000	0xe62f6ae10cce0bd6e153e6b99eb329f7066b20ee	957.36	20674828.098999323917458761	3916820	90	0xa771aa00936418b78e3efbddd2cf396aec3bf76ee9649bc6a97660cfc05e8ef1
2443	0x0000000000000000000000000000000000000000	0x9ec01bb07f90242cf79120d29aec0db80269d52f	478.68	20675306.778999323917458761	3916820	91	0xa7f1e4b7824d128e75616662a3a570dbc80b573420bf62ed5c36e61f24bd22e7
2444	0x0000000000000000000000000000000000000000	0x9fbe55e7fdb11b353e5b491eeee3dc2ca72e9226	51.649679703	20675358.428679026917458761	3916823	99	0xe8826fb299ac174ac0cb1bb61b7335287f216f2203db8c7f3c5cdd9abc1a8ada
2445	0x0000000000000000000000000000000000000000	0xa76011fde264beaa80294796c59bafdfb7e0f493	239.34	20675597.768679026917458761	3916839	40	0x0d7db0d0d2030c91f54ed10085877ae377ee65cf2465ab858946fbdd8a1a3b33
2446	0x0000000000000000000000000000000000000000	0xbb1da84f6eb6001cadae4c618910cee5f6b7c8ac	35.510444988	20675633.279124014917458761	3916841	43	0x126c5fb797db66ee90f1a45cc5a07cf0a7477ce3343711fdcbf41505c4cf972e
2447	0x0000000000000000000000000000000000000000	0x584d71aac1342a29e5ceac6cf39b334c35936d4a	670.152	20676303.431124014917458761	3916843	8	0x26c20bf1711a58c236c9c2cf25f384595f2faf02313ba24f94bdad519f314d5c
2448	0x0000000000000000000000000000000000000000	0x952d2841b459eb36a986737d5691597087f197ef	94.3496421972	20676397.780766212117458761	3916849	28	0x6e543d87f87027f4844f8eb80cd9d63b0c528df79b9b6501aaf5d938a529a9d4
2449	0x0000000000000000000000000000000000000000	0xad65167d705c7196d72520ec5e994f548f8a3446	47.868	20676445.648766212117458761	3916852	98	0x27ec59d7c3cd9ee6eb711bb854f6b351748cafa94a765bfbd61c20399308c4cd
2450	0x0000000000000000000000000000000000000000	0xb7fd42ab1a6d4423d55b64be0f80f5cec786e3da	4.7868	20676450.435566212117458761	3916861	8	0x40cffc2f3cb374131f53470928024bfb5e1caa18e5636f002d8bfc15ff74e30a
2451	0x0000000000000000000000000000000000000000	0x64133cc0a7cc3d6da61a098af35be9016f174314	421.29176037432	20676871.727326586437458761	3916862	49	0x6ece62aab01f0f00b6664914958f323e2387c18cea3649d4989be871bf155ac0
2452	0x0000000000000000000000000000000000000000	0x9b043e4437ef563ccb8e92c58a4b6e6b1f31e1df	4195.6302	20681067.357526586437458761	3916865	7	0x46ea94703afe1eb592d3baf1f7876f7dd64311a9ec22cff3bceedda87304b01e
2453	0x0000000000000000000000000000000000000000	0xefbd425a06e1ebdef00770ff04e56e0d8f0d57af	1914.72	20682982.077526586437458761	3916868	27	0xc39efb7ac33718b3810f7607bf70490b1ad27ab0d9efc16f60abba58cb64aca9
2454	0x0000000000000000000000000000000000000000	0xcb657e8b4efe897c968699a3ec0f6c3c0122e1db	86.1624	20683068.239926586437458761	3916871	48	0x68ea31dabc57e392095f341af9c91bf8ad31e4acaaf3dda971bca9e8e1f6fb2f
2455	0x0000000000000000000000000000000000000000	0x9c27762461c48f4102ac7d89e54e5de15769262a	1579.644	20684647.883926586437458761	3916875	47	0x91c4b2edde2f7ee633b461d0e1f4009636d854842722ec9d5e87b987d57bbf9e
2456	0x0000000000000000000000000000000000000000	0xa4ec22f9ffc8ce7c280f3d8154d3694729c6a00c	526.548	20685174.431926586437458761	3916875	133	0xe07b11a4468ec3127447e22ed57b24e38c983a704856b5431c871774161c1a0c
2457	0x0000000000000000000000000000000000000000	0x69b87e03453a86c899244c09f032406201935b24	581.56915458	20685756.001081166437458761	3916887	25	0xe962fdee867e5d20eaa3fdbc39c3671d639d98c08f3687faa4f8fdc31cd38098
2458	0x0000000000000000000000000000000000000000	0xafcf50291ef33e5b0c20a419a638db2e7e91b0eb	481.0734	20686237.074481166437458761	3916893	39	0xd5051ef4896f27fecd76c2460c7ccfedb9d0a7365fbdc91d0da946af8d514b2b
2459	0x0000000000000000000000000000000000000000	0x3ebb855b53b5056ae43c7600613f4986685c4662	957.36	20687194.434481166437458761	3916893	64	0xe7621c243c9661bb253d18cb368865c94521afd296a8f54e1775c1cc546ae134
2460	0x0000000000000000000000000000000000000000	0x401354a297952fa972ad383ca07a0a2811d74a71	957.36	20688151.794481166437458761	3916896	49	0xb424fe40ceff6d3c64ad5bde49452363a7a99c38ee13221cd352512e767c4638
2461	0x0000000000000000000000000000000000000000	0x9f2d1f068b946b03d8a700f8dd0d4b8095434ded	164.18724	20688315.981721166437458761	3916897	6	0xe8d09fc75b79eb8cd5698f0dca168e6bfbfe222e1ca810c6e2d87c63d442de82
2462	0x0000000000000000000000000000000000000000	0xad65167d705c7196d72520ec5e994f548f8a3446	2393.4	20690709.381721166437458761	3916903	15	0x1a5f9c18b5685fa8e036ff2dd4fdfba2e6abc515f1f5d34116a95f1096a78856
2463	0x0000000000000000000000000000000000000000	0xd907aea8fbe2c4e4c223d57009456616148089d2	957.36	20691666.741721166437458761	3916906	16	0x2e754d12f1f35396730157e6bbbc1cb0a8e39864a2adda071f352f6f2335f633
2464	0x0000000000000000000000000000000000000000	0x6c3fccdceece30afc1707efab141da59192c209f	148.3908	20691815.132521166437458761	3916920	82	0xd8ca52ba1ff0c48da69c68486358bb1ff2bd7d088378febb6f383ded5a5135f1
2465	0x0000000000000000000000000000000000000000	0x6c5ebecea0e070aeb5d4b692ff1f694cd35e8333	10530.96	20702346.092521166437458761	3916921	12	0x039ddc49edece0f84b62ea4d0d63ae7cdd23109c02e8fc5ade50fa5f026e8721
2466	0x0000000000000000000000000000000000000000	0xb7fd42ab1a6d4423d55b64be0f80f5cec786e3da	478.68	20702824.772521166437458761	3916922	40	0x90fb700497e6babc9a7e0e2c8c5df3f232fbe8fa30367e7cf43bfe1f75f6fbcc
2467	0x0000000000000000000000000000000000000000	0x74303b81beda2874e4a918a5ea0f292ae89794cc	383.997096	20703208.769617166437458761	3916926	38	0x075510556bfd7eca7e9d6c428dc07b4cf93645a78d74c7a3b1d3368f26f63eb0
2468	0x0000000000000000000000000000000000000000	0xf4073da1a7dc3d90643b16fbce89a60f95c20177	1436.04	20704644.809617166437458761	3916931	45	0x4bd93a632ee2d8c05f4df1f59b068df7256cbbc595503b6103cb267239c4a302
2469	0x0000000000000000000000000000000000000000	0x5fde446016bd7bca45360efcbd6e9b9896d3a4a4	478.68	20705123.489617166437458761	3916945	5	0x45b9a3fddcafe962dc690f38ba2c3549576fa5db81fdbf151dea9ac3e9ae673f
2470	0x0000000000000000000000000000000000000000	0x75b33995cb21539cb9cd09044771f5475b069e1e	47.868	20705171.357617166437458761	3916945	55	0x8e69328059d80e673e3725fe22a2951c43d3cd2e193aa33d9390e048e6424bbb
2471	0x0000000000000000000000000000000000000000	0x46d7071905b3b026118bcac697031ab0e00e4061	90.9492	20705262.306817166437458761	3916947	8	0x4c26a4785ab755d45063ead6420e21ed9ff5b84bf63bfc58559e4abc1b4e9bc0
2472	0x0000000000000000000000000000000000000000	0xfcd2bbf598fccc8a5e741af9b5c1fb37a5ea2ccf	48.34668	20705310.653497166437458761	3916951	10	0x05c9be37698f8b54b1dea45eace6988edfc1fec6708be097ac74c25a270e6828
2473	0x0000000000000000000000000000000000000000	0xc4d87b38f42233500f9e99c0f234d9f85273c455	4882.536	20710193.189497166437458761	3916953	128	0x1cd9e76008dc1c019e6f8c13c6a7a4b498ddd5ec0bbb38438afbbf44d194b648
2474	0x0000000000000000000000000000000000000000	0xfbb1b73c4f0bda4f67dca266ce6ef42f520fbb98	4786.8	20714979.989497166437458761	3916963	5	0x1dd2fdfa986e2f9baea675a0ba713a7941e33490e01a12e0f0ea96ea916eaa39
2475	0x0000000000000000000000000000000000000000	0x3831beb867bf6fb6d7fb901ab6fdaff73fdb1151	478.68	20715458.669497166437458761	3916965	61	0x9919212496ac2cf215c54ae479243a1c2f04f5b14e5ae1da4dd5c9fe28a26148
2476	0x0000000000000000000000000000000000000000	0x6eed8111552545867b34544e3bb18e140baee7fe	9.5736	20715468.243097166437458761	3916966	64	0x749c59dd1e198d156dd46772fc619fade9bc41205f58244185f0e86e5fcc20e5
2477	0x0000000000000000000000000000000000000000	0x6fd623ab0dff084df49975986ad8af7c306bf8b8	472.51672263108	20715940.759819797517458761	3916977	4	0x8798c88ebdac096c10a4ec21276f91a02ae2098335e5d2856d8d0bd7763f8484
2478	0x0000000000000000000000000000000000000000	0xc4d87b38f42233500f9e99c0f234d9f85273c455	4790.15076	20720730.910579797517458761	3916977	55	0xc0c9233ffe0b5ea539c95828f141684351a514a7a91bfa20a287b6b8d4d500c8
2479	0x0000000000000000000000000000000000000000	0x20d38cc5ca62994db5e3b8ec0924e9da022dd55a	239.34	20720970.250579797517458761	3916980	44	0xba272388d8e3e5716f8c0fa8dbb5628609571516a28ede7cd3a9ab8e828a19ab
2480	0x0000000000000000000000000000000000000000	0x151477142ad9b6f38e698c16829baea1b9cfd778	478.68	20721448.930579797517458761	3916985	19	0x31e8a77c938d8478de6d09ae6526d35f17add2fcc66449f08d70d5f5a7350640
2481	0x0000000000000000000000000000000000000000	0x88d053d544f0e1d49046be70eda64d2a6166b0f3	1.483908	20721450.414487797517458761	3916986	41	0xc8f929238854d12e63ac33e93d7cbe710622c03cae65c6295598d79d9a1d2511
2482	0x0000000000000000000000000000000000000000	0x5fb3dc3ec639f33429aea0773ed292a37b87a4d8	239.34	20721689.754487797517458761	3916988	105	0xbfd0b7147382df9160b4fa6cb8381fcb227d817a2198cf3337d25508721fda51
2483	0x0000000000000000000000000000000000000000	0x6519dcc6d97631e5aa0ae62a8f914b63ec273b48	14.3604	20721704.114887797517458761	3916999	8	0x79f8eb51bf431ce972ffcc0a29d562671acd3a2a56875eb678b68034c7cdb644
2484	0x0000000000000000000000000000000000000000	0x6eed8111552545867b34544e3bb18e140baee7fe	90.9492	20721795.064087797517458761	3917000	85	0x2fa5383c57433ac3c97d280361a2c4bf6b2e9d71a36510e7ba6a61563b0f61f9
2485	0x0000000000000000000000000000000000000000	0xbfd3ab4000de5c63ebacd88ab45485a25ae4c59c	603.1368	20722398.200887797517458761	3917004	24	0x163fa935968e9c125d859fe3d1b261cfc1d1001acbce6b9bfe3b0a3db406f2fe
2486	0x0000000000000000000000000000000000000000	0x25adb30498548c7810481ffe0355f22c765d334d	737.64588	20723135.846767797517458761	3917004	78	0x1c074431458e52c5652f763d9a4480dcb28aa85bf9e270539ede734a121896a5
2487	0x0000000000000000000000000000000000000000	0x8aee3359529c6ad3ec90db72eea9328b740db302	67.0152	20723202.861967797517458761	3917006	5	0x1d19d47cd7e837adee968e7873cc56cf815de3c2b558174ddd965524f91e853f
2488	0x0000000000000000000000000000000000000000	0x0963ed278943853e85bca2b75ef84d6a5e8a73ea	2455.8868872	20725658.748854997517458761	3917006	8	0xb9ee29048a05c7a404f3ecc6c4fa8925067d22e78d90d363573a82b4b075353d
2489	0x0000000000000000000000000000000000000000	0xe5ca66cf7fbd1f4bdaee3647b25832e941809c40	478.68	20726137.428854997517458761	3917011	92	0x762ae0cb9628f83e1d5c26f701c1341bcd5bf4b637f2e3333a0e78dfc1d707e3
2490	0x0000000000000000000000000000000000000000	0xe3232a655edccc466770d4634a86bf6fc8a88442	216.6027	20726354.031554997517458761	3917013	18	0x93b479d5d68fb8dd434e15199b985856f5358f1025f567b328f0b4da4cb9b19a
2491	0x0000000000000000000000000000000000000000	0x6485a46f24f858bc485e1631291a69ea569ebcf1	478.68	20726832.711554997517458761	3917035	36	0xea63d831e124ee9b411a5403ea7ca00355d7bb5e0910a28bad55c5870301128e
2492	0x0000000000000000000000000000000000000000	0x2ede66ed71e557cc90b9a76c298185c09591991b	71.802	20726904.513554997517458761	3917035	37	0xf5a84594f7c173f80fc2b93ecde937eb2592b7654a0168121cf4bc958e5e7dd0
2493	0x0000000000000000000000000000000000000000	0xae2953655f8d83e9fe62f58135b19c0d8135a043	239.34	20727143.853554997517458761	3917035	46	0xc1ee140f33a7e29f2ec6bae6313415b7b2e146eed42d8833b919baf29c107a3e
2494	0x0000000000000000000000000000000000000000	0x2d61811cbd24af3c19cf6c09cc4f1f154f56176e	478.68	20727622.533554997517458761	3917037	31	0x27ac9f61f55e7be3feb67d92eff04e08564f7496858aef675dd70bd6b5a26b12
2495	0x0000000000000000000000000000000000000000	0x4b90e5820fd896b286c857788e931117c8ffcbf9	478.68	20728101.213554997517458761	3917039	100	0x0863d0a7984951b61ed0bd0e8c1f7cab047796d57a2c8676ebb161335d7d2734
2496	0x0000000000000000000000000000000000000000	0x9bf90e0d30930d7a5053db5d8074ed02f69bf3b8	23.934	20728125.147554997517458761	3917039	103	0x6fe1d8fe4433158b9addb950d1200027248c783e337ff535edcdd02204101dc1
2497	0x0000000000000000000000000000000000000000	0xa3b019eff4df4908b10a23ecdc4f35a1591788ce	47.868	20728173.015554997517458761	3917039	115	0x04553fcc915745d0a6023c63eefdc1b69a41ed75f03e67fcbed373787b718bc5
2498	0x0000000000000000000000000000000000000000	0xfd58d9d90d06154946eb4a03e0736541d900b96e	4783.92792	20732956.943474997517458761	3917048	45	0x6856d63599e3c24ca6e00dca17e75e8c48dd4e54f7c2aaba97e9ecb8d3c382c2
2499	0x0000000000000000000000000000000000000000	0x9b0e2c7f4167d260008510a25008d9c96a0c1923	1492.13507316	20734449.078548157517458761	3917054	0	0x7128e3ef71d71127b2ba22eb5c808ae51e87ac0c6c9016d1c3f09c541b9bd2a4
2500	0x0000000000000000000000000000000000000000	0x97c7ba56078f510cc86e014c138af88d5244d758	47.868	20734496.946548157517458761	3917054	56	0x8d94c6f577ed8d49bd70703e1630c5ecaf16f5471c1721e8febcb11caa898c8c
2501	0x0000000000000000000000000000000000000000	0xe7e1a1ed96a5ccad9019f2c3fc858857f68b56e8	957.36	20735454.306548157517458761	3917056	22	0xafd6c904d4f17855fe0133fa7ce9ae4fcebe6c7fe9af6dfe5ed1237254fa27ff
2502	0x0000000000000000000000000000000000000000	0x19eb5c4ca4c57252b17ab565f03a4508fe0c28b4	28.7208	20735483.027348157517458761	3917057	12	0xeaa3dcbde96e11553518bd1ed7c3ab06bd322c9ed1d474672ced8543e0954e8e
2503	0x0000000000000000000000000000000000000000	0x931078c77f83334c0697845b900d8a2396c9f5a0	478.68	20735961.707348157517458761	3917057	153	0xb3ed08077ff46d0d63e9422921422898e4356b89deee7a66e23ae7421f8ab1ed
2504	0x0000000000000000000000000000000000000000	0x6485a46f24f858bc485e1631291a69ea569ebcf1	4308.12	20740269.827348157517458761	3917062	145	0x617d4cb8b582e04b372ddd9d8151151129b3777c4104865c29f622fc2646256e
2505	0x0000000000000000000000000000000000000000	0xeb371ec3ba1c6db4019f9bdade9716d340e5f992	234.5532	20740504.380548157517458761	3917063	38	0x91955be39c59c926b27e8b2004ac4bcae9899a0bcdba8fc5599740e069152698
2506	0x0000000000000000000000000000000000000000	0x98ddb53191a155d1a850e33b14bba7897aae4e7c	2393.4	20742897.780548157517458761	3917068	16	0x2443218f0fc55f22df0eac49ea26254979f88385852f6b53cdf0f81e3940e296
2507	0x0000000000000000000000000000000000000000	0x8dd44711498cf2b4830fe0f04830e9621f4cb987	488.2536	20743386.034148157517458761	3917068	63	0x8b410417948348199fae8f4fa132837ff44c9aedc8bd8cbc3004d81d8d86499c
2508	0x0000000000000000000000000000000000000000	0x9bf90e0d30930d7a5053db5d8074ed02f69bf3b8	23.934	20743409.968148157517458761	3917068	71	0x6c5bea60ed1053ac60a98a8d0ff5737c6727a3066fcad9909da43e85c59b404c
2509	0x0000000000000000000000000000000000000000	0x062aaf8f043ddfa2497b3b27f1e34e801fcf1422	642.008117103	20744051.976265260517458761	3917068	75	0xd257223ce8f87946eb71b622abbac0b11d23ffcaefa7ae1d0002aaa4f0c849b3
2510	0x0000000000000000000000000000000000000000	0x46a0abd4764d27b050ef6b5168f2f46ece7e3e42	516.9744	20744568.950665260517458761	3917068	89	0x0db0c610e9734861085242aa29fc477569d2c290c983a2f39acd6f8ca14978de
2511	0x0000000000000000000000000000000000000000	0xa4bf6e1e7088b039d526123bb1a1125fb25005f7	718.02	20745286.970665260517458761	3917077	22	0x3d70664a525dc191bf3c8ada87c675d2d582a2ac1ac834782db2ae9c5508c89c
2512	0x0000000000000000000000000000000000000000	0x412da5048c1e0fb056b5747599dfac748b432058	114.8832	20745401.853865260517458761	3917078	0	0x2fc0220785d1e2d3263d88a746308d275385ef71e383a4d1f9a7465f0fa54b30
2513	0x0000000000000000000000000000000000000000	0x6e8967f0d6cdbb79cef31571b9e68f635565a24c	475.80037648188	20745877.654241742397458761	3917078	37	0x3a60fbc73a5e991734590bd24ebe1282dfc3f789963822a0d5f589763e3e3470
2514	0x0000000000000000000000000000000000000000	0xdd43971cf32d309c4e778aaff8edbbdbe1a0a66f	478.68	20746356.334241742397458761	3917082	37	0x9e18dd3c4543ed868679d6f4e0b7f56d5606609bd53ea8d0b3ecc6fd77d6647b
2515	0x0000000000000000000000000000000000000000	0xebd83c513236bb159cf7a9bd21ce5f4a84c2d8bb	478.68	20746835.014241742397458761	3917082	105	0x321ef99a785efebdc7afcd2cfd0fb1ca6196edb262aa8b530714c36a9cc63a94
2516	0x0000000000000000000000000000000000000000	0x803c7637d680c8b21c8e42a5a2d5dafd06a6d0ef	397.3044	20747232.318641742397458761	3917084	57	0x743075b80eaa58dd71892f91cce1f72b5ea16dec7aac63373e993a0068ec622d
2517	0x0000000000000000000000000000000000000000	0x69087e5314215f598ff73fcaa5f1822f269b5422	631.8576	20747864.176241742397458761	3917085	33	0x895e877753dec71c32b5ae2c0cd146884eab39d956c3da5cfba8d44b120143b6
2518	0x0000000000000000000000000000000000000000	0x19848bde98107d72795bf5415fa70d3f483eea36	335.076	20748199.252241742397458761	3917085	40	0xae93b0ab1b48b3588bb5ef1e54602e197d26a9c745670ba4d6ba191d0542082f
2519	0x0000000000000000000000000000000000000000	0x8480968eef73b941c6290b6f1858732f41a03471	957.36	20749156.612241742397458761	3917091	45	0xb6daec0ea2f690f135006398e840d4007543c8e367f60e51fa973268c31db5cf
2520	0x0000000000000000000000000000000000000000	0x16d4245339ad98bb67b546b9725b083bab6fdc78	957.36	20750113.972241742397458761	3917091	50	0x501b2eaa9faa28cdeccaa7d9b092ddb550c793f82f89113d46767430a21b4712
2521	0x0000000000000000000000000000000000000000	0xedd087445245404381ed4aae6541d24cc0ad5f46	95.736	20750209.708241742397458761	3917094	22	0x86757b10a49a0d5a3e258fdf9465ef948e9b9555e255f300d91260cbf8cd3dde
2522	0x0000000000000000000000000000000000000000	0xc51334b08d358b2ed23e9f9c1be26cf855d01e68	243.1219645176	20750452.830206259997458761	3917096	9	0xce65258bd9fdfa6ad924a8fa5bf090a6ef06e70f7f7d857adf30ee5df81d61ee
2523	0x0000000000000000000000000000000000000000	0x4cf7037aeb2962a18b2e08aa140f07cb53e1a957	1914.72	20752367.550206259997458761	3917097	3	0x8f7252c0f4f8bb64f76317ba46539b828f836bf185abf1128df6b23df656e09f
2524	0x0000000000000000000000000000000000000000	0x412da5048c1e0fb056b5747599dfac748b432058	2383.8264	20754751.376606259997458761	3917100	0	0x2f6b846e5b3fbb471787565f2ecf6debeae21e84d8af41fb619846fd41445a75
2525	0x0000000000000000000000000000000000000000	0x04da469d237e85ec55a4085874e1737fb53548fd	478.68	20755230.056606259997458761	3917100	56	0x09b4c145ecbab75fc6c19b6cd6314cd5d838bfbdfbff4895f076039f29ea21d6
2526	0x0000000000000000000000000000000000000000	0xe1cd85ad3c8f14097b58cda51bc9ae8977886195	95.736	20755325.792606259997458761	3917100	115	0x9883a615c0d01f0acf356a0f98e254185dc20b4c5c246643fc52c8fe95f7664e
2527	0x0000000000000000000000000000000000000000	0x840c59f8f0547f2eed4539b69a408914a78e3a9e	3829.44	20759155.232606259997458761	3917105	36	0xb1a9c415ee4fc3e304fd076b255cf639f208892390567224b2f179d4725118fb
2528	0x0000000000000000000000000000000000000000	0xce15d11c99657f9f9e65e79ea8994b360e545314	813.756	20759968.988606259997458761	3917112	20	0x308ae4ff83bc1d6e2fcdf2dbb46862ebbd8e96d432033a2dd513880b191f31fe
2529	0x0000000000000000000000000000000000000000	0x7d675f49526a9e017d0ad6bc6821297b7074eb8f	478.68	20760447.668606259997458761	3917113	5	0x0d25c8862041e8f7b5cdcc4fa31055a46f2b13c39d440dced321ead410446cb4
2530	0x0000000000000000000000000000000000000000	0x16d79d8116744b618241b64f1720de71bf02fbd5	8032.2504	20768479.919006259997458761	3917114	6	0x560bf6db37f0067deb8f196b6f516efe44d028447178ed0348e111a5b811fa29
2531	0x0000000000000000000000000000000000000000	0xf5b8cd89ae71e9cfc9882a6dbc429050c708382a	2393.4	20770873.319006259997458761	3917119	60	0x3503161cc1850d12bbd6b9e0681636b1a4c364a263bc5736bc6c3cb09102c2f6
2532	0x0000000000000000000000000000000000000000	0x90c3c8e2f98b94e2344327c743ab3aaeb5b7f1a1	3829.44	20774702.759006259997458761	3917122	8	0xe1d44ae2d9887f4ebe1c0c03e15b82c8cf75258b7e0d4a38c491ff2e8dc23c59
2533	0x0000000000000000000000000000000000000000	0xeb371ec3ba1c6db4019f9bdade9716d340e5f992	1144.0452	20775846.804206259997458761	3917132	7	0x2bb22c2888de942bf17c727f762d7a1c9b752ef9f8196182b1b4fba9a36ebb75
2534	0x0000000000000000000000000000000000000000	0xa649d7ff2f47fd8d270d2683f38e6c464b9cbb52	1675.38	20777522.184206259997458761	3917132	16	0x7210193ef443c43188b788dfec126d21d03ba4bdc2b2ac625a59be7816853153
2535	0x0000000000000000000000000000000000000000	0xd3d4a052d2cd4990c460c1cfbf8bf5451a2ed787	478.68	20778000.864206259997458761	3917134	50	0xcd7ca2b66ec95cd686d865fd136953cfec2506d5e773a29bf885aca0691da165
2536	0x0000000000000000000000000000000000000000	0x6a72b74cda499eb0dac946df5ea4f3447eb58dcc	239.34	20778240.204206259997458761	3917137	50	0xc87f74d023e222820fa1c06eb4d6ea92c2e28eb09b46ca201f8567cb6f6b008d
2537	0x0000000000000000000000000000000000000000	0x8c651c84fb31e6530b4ad299b47ab2d6497580d5	118.822844103	20778359.027050362997458761	3917137	66	0xd18f0fbd3b84291951d0b086c38017d1d0941105078513afb28dddd92acbeb41
2538	0x0000000000000000000000000000000000000000	0x9b0e2c7f4167d260008510a25008d9c96a0c1923	53.61216	20778412.639210362997458761	3917139	88	0xe2861d24cbd0fb1d0f8cf87c5d0240f20a324113dafccb32a36de5ba7924fc5b
2539	0x0000000000000000000000000000000000000000	0x0eb31397368b6dad61fcfb374b73faa1a558f336	23934	20802346.639210362997458761	3917146	82	0x055438a1b10ff72dd824c39dda7fe1774a48e8f52e00a06dd6a4b545ff1c65dc
2540	0x0000000000000000000000000000000000000000	0x0eab3a88e0c56441bd261e57a6bbd79aa289edca	1.43604	20802348.075250362997458761	3917149	77	0xddf90c590efcded82d3458303674cebfc0cacdf56cf74e1b872745fe4b7feb62
2541	0x0000000000000000000000000000000000000000	0x71b15f82378aedbc4a918eb84f34450d53ba6f64	1436.04	20803784.115250362997458761	3917152	2	0xff054b89c0dfa1545a5f1672681fb93b517bfe4b619dc75155b773d388655970
2542	0x0000000000000000000000000000000000000000	0xe3d60c92d81ea9c635e87a9801a31fedb38b25a6	382.944	20804167.059250362997458761	3917152	71	0xed53f0a5d4e1f8f92fbb14b8abab9e72ca6c517f29c94330dd0d809ec9990ece
2543	0x0000000000000000000000000000000000000000	0x224d9ba48890227e2feb296bf0a654c9f18cee2a	478.68	20804645.739250362997458761	3917153	16	0xcaea1f047011cf7922f04bab2d1db13f0f7a07d5d848f290995ab7f5d00fdac7
2544	0x0000000000000000000000000000000000000000	0x5dfd071ff8886baf11d763685eef5fdc730d1f72	1415.90663016552	20806061.645880528517458761	3917154	4	0x9ad74666c57a66f3bb32d339420576a7f1530d8906d7f09b8ce4d25fdebce1e2
2545	0x0000000000000000000000000000000000000000	0x88cb0a5c274070eea8cf924de98ad9ffbfd550cf	81.37441239492	20806143.020292923437458761	3917164	3	0xebf0db090416f7234cc8567accfaf64e51cd1652d9db6cefeb84124f922b2d7a
2546	0x0000000000000000000000000000000000000000	0x4f05daeb476f0b3b9457ff00a71f1d3897077e06	478.68	20806621.700292923437458761	3917170	3	0x66ccfa245d29be4994a4769bb835159947b239c0209a34d4ea516392a6e1f0d4
2547	0x0000000000000000000000000000000000000000	0xd34aefabb455bd4f2880686a66b5cf3b9cf208f9	1914.72	20808536.420292923437458761	3917172	6	0x250422f2567724eccdd6d9a4ecba87d0293c0580c227d8ad0ebfea21b1f8b4d9
2548	0x0000000000000000000000000000000000000000	0x1be4926b25fbace3489b34f1f8c790ed56dc7245	481.34554489776	20809017.765837821197458761	3917176	2	0x16f0e633c939d5ffbc57e391b17b77c95f2a0895d2cca27e70e565aa51fd49fd
2549	0x0000000000000000000000000000000000000000	0xbe16c34d102cf6ead1f80af5f7ad82cf607412d9	167.538	20809185.303837821197458761	3917191	2	0x23fa3ae0357228111d3eeea19e8913392bac1c51845b381572a96eef880dc2d3
2550	0x0000000000000000000000000000000000000000	0x1162dc41b756c754e80f3bd3f1668097ae3cb249	718.02	20809903.323837821197458761	3917204	54	0x95291a99993e38419734a233442efcdb63960701463591556b6b0a83075aed37
2551	0x0000000000000000000000000000000000000000	0x0eb31397368b6dad61fcfb374b73faa1a558f336	12924.36	20822827.683837821197458761	3917205	20	0xdf81c195560e73fea84f5c55be53d8c7d3f1796e655aad109f2d9b8b9a8a7bd4
2552	0x0000000000000000000000000000000000000000	0xd98cfe0bb7c78c7c14f26f436183b2e958d6ee8c	4786.8	20827614.483837821197458761	3917208	31	0x4e3baa31b871b6eae1b093ce1171653cd204b252cc60dfa43d2c33b2c17454cf
2553	0x0000000000000000000000000000000000000000	0xe60afceb04c56401ca9448b2a83e32d7fd0cea87	478.68	20828093.163837821197458761	3917208	33	0xa9450763ac58b4d12ccac8cb4581a10cc6f1cba82067c53d05109ce8059a095e
2554	0x0000000000000000000000000000000000000000	0xd34aefabb455bd4f2880686a66b5cf3b9cf208f9	1914.72	20830007.883837821197458761	3917209	5	0x6337975dd96daf3e1868432d1ee5ed51d4ea4a3962dbdd7fe023227d45eb0d38
2555	0x0000000000000000000000000000000000000000	0x8480968eef73b941c6290b6f1858732f41a03471	239.34	20830247.223837821197458761	3917217	39	0x35f2b5e4f3dac85bcc7981f8d4c99765d6c3009ebb4af215776014da03bae105
2556	0x0000000000000000000000000000000000000000	0x527bd4a51998f9cc7246f2427f1ea5e1c4d4609c	718.02	20830965.243837821197458761	3917222	0	0x98e33bef17b9b40041ce604a492e8903d352051bc8852865a6692f018ddd8b47
2557	0x0000000000000000000000000000000000000000	0x412da5048c1e0fb056b5747599dfac748b432058	143.604	20831108.847837821197458761	3917236	3	0xfc5824dc8460ca6766373b8882b5aa6d1babdece5d4768cbb276f31df93b3fd5
2558	0x0000000000000000000000000000000000000000	0xebbb8c66463e9486afff052d28327b533585b7b1	382.944	20831491.791837821197458761	3917236	9	0x4c10129c3212cfce2cba8faa6c7ce5115be36875bec7519c5e93100c7edbdea6
2559	0x0000000000000000000000000000000000000000	0x0d275e4e58ce5f60b31788403cb9e3214c9d00ac	957.36	20832449.151837821197458761	3917236	11	0xf1da8ba4562c31e8f2e577c05e9a7a95dd59842c0a21d753d52557b46ca502b0
2560	0x0000000000000000000000000000000000000000	0x335afef9c002773aa2923eb09f8d534606432a94	634.251	20833083.402837821197458761	3917237	5	0x58175dc2f95865c0370bb287536ae3bc0f555c8d373e5b86529f865bc2db0cad
2561	0x0000000000000000000000000000000000000000	0x3bc9b2d6a5ff6696392d5914818e3bb07811d0f8	478.68	20833562.082837821197458761	3917247	9	0x70ad2380bd90e6deb88c5beff84d616899867b8eb6ac0e1c5aeb466f6081f3d4
2562	0x0000000000000000000000000000000000000000	0xc48370f405d526cd2da5e6f12335973e5a321eeb	72.6342186876	20833634.717056508797458761	3917251	2	0x774cdc367b928d6760af6f5a3982e2aac8bdfbc8c9f35c670576e0346cc4a722
2563	0x0000000000000000000000000000000000000000	0xa4f8f4b77eb7f4982a5f4932586dc70e24aceb36	478.68	20834113.397056508797458761	3917262	10	0xcadd3da6f7471ad73783950221893acbe43ad3d66c10038c0cbe7d9391c09d93
2564	0x0000000000000000000000000000000000000000	0x4b6a7c73e694587b54fd49cf93f543258c0ab104	5911.698	20840025.095056508797458761	3917264	54	0xd75ddb3f49b4330700f9063a168dc0aa3b573ede4e5de82b0ccc595e3b757acb
2565	0x0000000000000000000000000000000000000000	0x3a71d63032b2311df2d2374c29e3a5642c6505c1	947.7864	20840972.881456508797458761	3917282	82	0x7be7a0caff20f96f83b2d741975ed8ec31ff870ea1d725814069984ebc6d4f2d
2566	0x0000000000000000000000000000000000000000	0xd1ab91a9875390ac6d656e93144ce21b97ab19c6	239.34	20841212.221456508797458761	3917282	88	0xd5c424453a0d8fdf9ff42a4bfa29ff3cd1b6a27e3815feb5a6ef5186f56dd376
2567	0x0000000000000000000000000000000000000000	0x3726ed6b2f470ae8e411d5c2c70ef2cb23df9bc7	9.5736	20841221.795056508797458761	3917282	92	0xf1415a339ff4497a006f55136501c83e339ad662f970036b0cb9b4c4f961e75e
2568	0x0000000000000000000000000000000000000000	0x3c6211a64508c45f5cd9fee363610d9dcb6000ed	81.3756	20841303.170656508797458761	3917286	103	0x0ba0fb5b19d1be09e07183ed7dc52b99fc48c887255eda3ffa25bae07bea8d6f
2569	0x0000000000000000000000000000000000000000	0xe891cdad7e3028406082ec260d8ae60eb9129d44	476.238732	20841779.409388508797458761	3917289	54	0xd6eb8634f15bf139b40f256f94c9844252b297dfd722210a0b521360000d3f20
2570	0x0000000000000000000000000000000000000000	0x0819743fe98dfc6b5604672bba5473c9ad660b97	3614.034	20845393.443388508797458761	3917301	10	0x56f017bc617005830d3e6a247b1d17d47395b20e1b5b6a31eea35ffaafebb5fb
2571	0x0000000000000000000000000000000000000000	0x4fd99d6e3fa03ccce09398a58540a18544d91f50	1436.04	20846829.483388508797458761	3917301	41	0x63f4d9deea3deb18b33546cf1c27923c9d1fc9d4cdab9f20c30f71553a338b02
2572	0x0000000000000000000000000000000000000000	0x7837f4283458e67dde737b3e639bb428a6c1423a	47.868	20846877.351388508797458761	3917301	67	0xbc51d8bb18183d5a819d96c4c495fefb8634cd5fd53d3aaa63396219ccd2bde1
2573	0x0000000000000000000000000000000000000000	0x35be338432265d60b4f3b79d0d6a0ed0311f372b	2872.08	20849749.431388508797458761	3917304	3	0x4e1bc8af1afae963bb580228628292d7ceada1d4de1b9d9fa7e6632782be79e0
2574	0x0000000000000000000000000000000000000000	0x9004ed8bce3fd0afcbf54d60977798ec09d43b34	5265.48	20855014.911388508797458761	3917308	57	0xcccd874dee4af7feb9c21f2e84c97b46f09c5a5abe29aea39ebcdd094446d6a6
2575	0x0000000000000000000000000000000000000000	0xeeb91d149c0685d759d2375c0f13ac6a5238d3a6	478.68	20855493.591388508797458761	3917310	41	0x1adafee56519a668a4ef1239804616101f1e9034262979ed075065c47d247f7f
2576	0x0000000000000000000000000000000000000000	0x6688c2fc0a565e1ca7f6a5898c91da7835dd6776	478.68	20855972.271388508797458761	3917310	52	0xd48a8af6442ebe388f8975ce8aa44eb97d36ce1eb29ced692450c5b4321cdb01
2577	0x0000000000000000000000000000000000000000	0x40d1cb3e3f5224075970de8b9ed1d252497ee448	355.084824	20856327.356212508797458761	3917316	9	0x468841b5f17b679760aba6c46ee7d185ddce65bdf7844059f2ced69f80dacf0e
2578	0x0000000000000000000000000000000000000000	0xe68eda08389e8642e7b13fc2e783f41150830a02	478.68	20856806.036212508797458761	3917324	43	0x2d125366e033df29cc867ba808b7f5f51f93265ffc9bb21365454aa11cbbde41
2579	0x0000000000000000000000000000000000000000	0xcbbdcb66bde49cd64417df0a3105911bf1da594e	433.2054	20857239.241612508797458761	3917333	13	0x519c44b47ce672c5a96d20740b57c6bf2a21ff50da74104057542407e18471ad
2580	0x0000000000000000000000000000000000000000	0x007ab8fe04ad2863cb6881caa6744d522c532b71	872.93166425328	20858112.173276762077458761	3917338	23	0xb98128746fc4b0eff5f8c40be943e058c73eae7dce2c5f866926e68e4b6c056e
2581	0x0000000000000000000000000000000000000000	0x7c81a08d4451046f89d4d91fca1b1ad968698f46	478.68	20858590.853276762077458761	3917340	31	0xcdb3fb54b48cfb3c711d40b8770d905d0fce4b0e4567cc71acde1571ad1b6e1e
2582	0x0000000000000000000000000000000000000000	0x5a8c6ff687817a54520cc5061015c1310b309a46	478.68	20859069.533276762077458761	3917348	12	0x534a6de90d4487d0d05d2c6c29c931d6a63260d982329fcc84fdc6d9a9ef8a95
2583	0x0000000000000000000000000000000000000000	0xc31f62974d72f47c09253176c151005439c9eb78	1100.964	20860170.497276762077458761	3917349	17	0xed40001e6d366e7d0876029f73a9d11750cad59317d22eccf4cd208c88c11d16
2584	0x0000000000000000000000000000000000000000	0x6d2202fc79647f82118dac336324a351ad026223	144.56136	20860315.058636762077458761	3917361	7	0xe6b10abff4dff11dbf56ca1dc910dcf122c7470d689ac03b6cea92616df099d8
2585	0x0000000000000000000000000000000000000000	0x848fa9ec76391b94a83442170085f8ca863b1624	1436.04	20861751.098636762077458761	3917367	8	0x695b568f407f31a938bce75d29f50a5a07c92c90ead07b4b6e127a2d5c78b3ce
2586	0x0000000000000000000000000000000000000000	0xf899b77d353cdd6f02887110a9c8aec2ae34dbf0	95.736	20861846.834636762077458761	3917368	20	0x23cb1497e0f84b4968cd854121c1b2ed902693700ee5394bd45d3b9d31241a53
2587	0x0000000000000000000000000000000000000000	0x203dfed20e49ff4834f1cad58c81cb7093032882	2114.80824	20863961.642876762077458761	3917372	40	0xe688a5835ba0e3195102842ef4518f3c19d9e4b4fba86e61922c6a0e66e5cf24
2588	0x0000000000000000000000000000000000000000	0xb88704d9858c0ffdc3cf17dde11f597f21f7bd01	22497.96	20886459.602876762077458761	3917378	2	0x59a5ccb528b9c6e5d4ceb91f2203a89c9ac426cef2d2f5141de20d2f3bf69a76
2589	0x0000000000000000000000000000000000000000	0x1d0738b927dfcbfbd59a9f0944bbd1860d3b9248	4786.8	20891246.402876762077458761	3917385	13	0x6a0f152072479235f0696bb99b95f148d632d54bb497204ba4e30ca788e9c233
2590	0x0000000000000000000000000000000000000000	0x58b458eff822aed62647334734743be09f417826	103.29077523756	20891349.693651999637458761	3917392	9	0xfa5c23108124eb5b38cca5cdec99feb3ff97954e7a0f169255e07c9ac6e3bed9
2591	0x0000000000000000000000000000000000000000	0xd4b3731451de43ad92166a9866cb90795b6c85be	52.6548	20891402.348451999637458761	3917392	23	0x6eef554ecc2a3f862c4340e473d99384fcb270778e5490c78c3c350763350e5f
2592	0x0000000000000000000000000000000000000000	0xf899b77d353cdd6f02887110a9c8aec2ae34dbf0	1431.2532	20892833.601651999637458761	3917399	36	0x49baa0b09972d8a33e59fb2b403819fd457407d0e8df3447aaa7f2e5f5f78467
2593	0x0000000000000000000000000000000000000000	0x72c6cf85bb7243f2b09b80e2c0513d38a39b86a3	1914.72	20894748.321651999637458761	3917413	9	0xd4bab4ba994d989c37d570922deb6bc4e8979b24971737836d98ba8c61f41400
2594	0x0000000000000000000000000000000000000000	0xdfae8b940186f12be4f19a0cc75bcf666a4238aa	459.5328	20895207.854451999637458761	3917413	34	0x408f21063ac24316b64913b08cf3cf5bc1ef6fa8d112ca5e9590d743dba3bbfc
2595	0x0000000000000000000000000000000000000000	0x848fa9ec76391b94a83442170085f8ca863b1624	1436.04	20896643.894451999637458761	3917418	13	0xc33e03df27e8d1eae784ae029cd33d5716c3d7de6c3643307a15464fb15c180e
2596	0x0000000000000000000000000000000000000000	0x8c37423ea5074b8532081407acff48a397d6b6c3	813.756	20897457.650451999637458761	3917419	17	0x5a54790f284aed249ecb90cc3f539c5e9f2afb4405282da0dadb1184ede4fb37
2597	0x0000000000000000000000000000000000000000	0x4942a1e21e7045871273f225e549b2301abec4bd	631.8576	20898089.508051999637458761	3917419	23	0x620707ecf74ad190c2e989f8a5a165ceb351ab243d4eabea2d86d63edf13b5bd
2598	0x0000000000000000000000000000000000000000	0xb178bfe776bb2bcfb4016ecacbad41bc6dd037a8	14839.08	20912928.588051999637458761	3917419	24	0x19fa772ddefc60327c625b496ad9ac2241ebdfff7ce02d2974694ec12888ff85
2599	0x0000000000000000000000000000000000000000	0x2fe251c3f1389b25b4c716162735e505690bfdab	2680.608	20915609.196051999637458761	3917424	3	0xb9e98208ea57e41b0cd9d672a9d117066dd13ce5f7ab46b0a2906aedde7ce24a
2600	0x0000000000000000000000000000000000000000	0x2126a604190d8a3485e20778473df338513278e3	8132.7732	20923741.969251999637458761	3917427	27	0x64b888a2a7d8f30c7d164fc49f7d64e918fdf80098bf3253868392f40db95888
2601	0x0000000000000000000000000000000000000000	0x2ad64309f1b144ba7ea30135748f2b2d96e77013	861.361217728870486355	20924603.330469728507945116	3917430	47	0x4716a25c9b0f51cf44bfbc5baed10f4b9f9e94bedbc4b197d7ab5737d96333d4
2602	0x0000000000000000000000000000000000000000	0xb15f8a780dd0374b91cb52aa03e8551dffc45b12	473.8932	20925077.223669728507945116	3917431	12	0x329d68411d977155de83abec37c908577872599f5f0fcccf23c43a88df1511ca
2603	0x0000000000000000000000000000000000000000	0xa58bdfbabb26646642016cbc6807f16487bae309	9573.6	20934650.823669728507945116	3917436	5	0xb15d4db1c2888e7cf0a3a106b0502d23864947d237847769e728eccdbf7777d8
2604	0x0000000000000000000000000000000000000000	0x23cdcdfcf58a593ed16cf8ff5516a37fee1d48d8	478.68	20935129.503669728507945116	3917442	72	0x65d4924fc65ba0fac16588f17ddb5fe2db940be05310247af7a128e7dc450b81
2605	0x0000000000000000000000000000000000000000	0x12848a1b958846d4d96165c993aa1a9401e29976	1529.4922703748	20936658.995940103307945116	3917443	96	0x1e287ed743f24c826f6f2afff7a2eec8e0ceb5bbf739572a8f7c4b16902eea45
2606	0x0000000000000000000000000000000000000000	0x9c70f3d395f64211148b745ea12613f3e02e7a8a	478.68	20937137.675940103307945116	3917451	2	0x4aa427898a6160532e3912fabed793cf61d388286bab2bffae1a37d5dc8667a1
2607	0x0000000000000000000000000000000000000000	0x84f681d86c65d2176a9cf57fed87467a9aebea50	239.34	20937377.015940103307945116	3917474	71	0xf6f7740bd83d48e18b441c15a44471288aa2307f372ba96355f9077300a87ced
2608	0x0000000000000000000000000000000000000000	0x7388ded1623acf72259e43fb3bac63f8a384ab08	119.67	20937496.685940103307945116	3917477	18	0xda34eea8b7b110493cd3db4f9312a94b7f053d45a74b11dc05eb1bddf82421b9
2609	0x0000000000000000000000000000000000000000	0x8204071588896b676dc1f13e3e2ea68b5ebe5e16	476.2866	20937972.972540103307945116	3917477	26	0xbf8beecca8820c48a018cf1f5120274899040e3f68694a6b9235b4a38d080472
2610	0x0000000000000000000000000000000000000000	0x9c846d06bf133e669cf90bab14f67b808f53f53f	127.32888	20938100.301420103307945116	3917478	35	0x43217d191ec21362b586a27cf9124844da245172a56ab57e2cdc7fa7d69c73b5
2611	0x0000000000000000000000000000000000000000	0x24318b0bcdd034215c0e312eedb5e9d6b4700504	8616.24	20946716.541420103307945116	3917486	4	0x1cf01f12e81c09693e1d3842019a97247dd2303cdfff6cadd9438d5afacf7b34
2612	0x0000000000000000000000000000000000000000	0x00b3ff890f26c5d6547a2d189cc4c32b3f8a2cad	33.5076	20946750.049020103307945116	3917486	13	0xd5390a4647fbad059afd27a38d04523c3374c16b74d386a53c80bf04209947ae
2613	0x0000000000000000000000000000000000000000	0x774c988ec49df627093b6755c3baebb0d9a9d0b3	22.01928	20946772.068300103307945116	3917489	31	0x2bf0faf230b10b7da4cab64704ea91361ae49ed1e4c9cb370c2b3dd36b13b491
2614	0x0000000000000000000000000000000000000000	0xf55a6c9231f7428bfc25997b39d5ebd87b8ea44e	239.34	20947011.408300103307945116	3917489	33	0x44f776531cc0463ab2d762c0417505575a6dea5a0e2d857e4877231fbe17236a
2615	0x0000000000000000000000000000000000000000	0x9915e24817654c4bb75aff8e71a7445c57cc4061	27.76344	20947039.171740103307945116	3917497	27	0x2a9c7601ecfc3126aa215983cdb2b3901529e9f3248096c9ba7d2405225938f1
2616	0x0000000000000000000000000000000000000000	0x0333b2629a02347c0435255663a6d45045a2940d	470.06376	20947509.235500103307945116	3917497	36	0xdad9bbfc9b3f0ac427b10cd41419b17f62d5eb1c3366775eeb58679f2010bee0
2617	0x0000000000000000000000000000000000000000	0x8f1af13f6639bc9fd05a5751a677ec6550291bb0	1914.72	20949423.955500103307945116	3917498	33	0xc1d464d18119101422e2c2ba78c37457ce6927e104e7ba665a896fb8e0a1e1f0
2618	0x0000000000000000000000000000000000000000	0x000103d7eb8c5a5c86939c4affedcbaf4ad3bcb3	10530.96	20959954.915500103307945116	3917500	2	0x002ff79b93e345e89152c0f895efca1ea5dbbbeafd53236d8fdaf48e1d2499b5
2619	0x0000000000000000000000000000000000000000	0x25d4cd2deb6dc8f6dc91ea4561819341bbb8e5d7	478.68	20960433.595500103307945116	3917509	56	0xf4779176e1b5e509ed83a6108c654a43447151a12ea3d3ed81ae9ecad030a18e
2620	0x0000000000000000000000000000000000000000	0x7e0a02637b8cf8bf57ce962a6215d03d8a108c44	478.68	20960912.275500103307945116	3917511	37	0x371c205a788ac5a05b042fd71fdfb75a2a7d4d398e3194647471a47480e3eaf6
2621	0x0000000000000000000000000000000000000000	0xc95ed3844cfc92e68ab7b0cd72e832a3f6eb0259	622.284	20961534.559500103307945116	3917527	16	0x34e16cb27e2ccb074978384c0d6ddde07531f328f104a2e5a78e2be40f38e8e2
2622	0x0000000000000000000000000000000000000000	0xd7146681600d31717a75ae4d4a8d5df2ded23e6f	95.736	20961630.295500103307945116	3917533	21	0x34b8bb55ad0cda309dbe97976ff87d57a8a5cccbd0bffbc971bc5f1741fb1343
2623	0x0000000000000000000000000000000000000000	0x6a98275c5a3e7db576cd10f9e0424d21f27131f7	519.020757	20962149.316257103307945116	3917540	8	0x61aa677ce79e4cac8a811543fe9f7347e765b76257009685ea7bfd97a02aa651
2624	0x0000000000000000000000000000000000000000	0x615b9351251b05a8ec82b97c667fe31ea4a1ed16	478.68	20962627.996257103307945116	3917555	23	0x23a949a454d6cafb094be69d49947b0e39b7ea847be662118ebbc4d91ec7b7e8
2625	0x0000000000000000000000000000000000000000	0xac6f5d2ff8c3a23ce78186f09248e5852b1ec19c	101.575896	20962729.572153103307945116	3917574	18	0x5d05cd1a0444e03c7c253ff5b95cd7aa521d7b5883453678b1df281a7479d8f2
2626	0x0000000000000000000000000000000000000000	0xb13b808b38d04fdd951759234e0dc25a0e8a3026	3.925176	20962733.497329103307945116	3917575	73	0x0f1d96f18fe207a98458582a22525bce940780394575452b56e834a014826bfd
2627	0x0000000000000000000000000000000000000000	0x26d8d7571bb525b52e5b7639ef09b58945bd79db	909.492	20963642.989329103307945116	3917591	7	0xb791dcf92d444f7f80d3fae7656874bbbf468f25517c032b6db1670e27609114
2628	0x0000000000000000000000000000000000000000	0x40d1cb3e3f5224075970de8b9ed1d252497ee448	2.728476	20963645.717805103307945116	3917593	30	0x389e16efb16cc990cf8f32e0b6332ac4f75deddd2daca5be96952fa54f08671d
2629	0x0000000000000000000000000000000000000000	0xda1574acc789130ea8a626895f7ac61f785f623a	43.0812	20963688.799005103307945116	3917597	2	0x10f4e8697adb3ba4894a7bc559401010395f850d1249f51e6a4805caa8e5fc97
2630	0x0000000000000000000000000000000000000000	0x16287389ea32b47da2341859e12b9238fd474b73	2872.55868	20966561.357685103307945116	3917597	3	0x2c21393efcf700a1e7646e4ccf8ccba36daf5294ce659e286151abdba4d2b80f
2631	0x0000000000000000000000000000000000000000	0x6fc97c9abb1f8aa1a995d8ff41c9c0f6ef8a1dfc	4.7868	20966566.144485103307945116	3917625	4	0x11faeb7b7ffb0d24747e405239c14e39fcfadd2e9b54e2c65260b09048d94353
2632	0x0000000000000000000000000000000000000000	0x9f2aef45d3ff8b77807d3a20658e16b7f4f75c04	71.699969358	20966637.844454461307945116	3917630	108	0xe677187a7e7b906a455b2492a78da6a81f2d13ab0f2f6a735dec3d6fb3d243ea
2633	0x0000000000000000000000000000000000000000	0x6fc97c9abb1f8aa1a995d8ff41c9c0f6ef8a1dfc	9.5736	20966647.418054461307945116	3917633	5	0x1ea9f465d39fa93d3d0eceae1b8d8f618f89d4bb0c4e8c96ffe8158a96b93898
2634	0x0000000000000000000000000000000000000000	0x69087e5314215f598ff73fcaa5f1822f269b5422	899.9184	20967547.336454461307945116	3917635	2	0x8e0b5e4d68c9abbfc6f532d24a62203559cd7cc8e88554e7ae64c39e6886799a
2635	0x0000000000000000000000000000000000000000	0x27fca80168b7edc487b22f0f334ba922d1e26e2d	2393.4	20969940.736454461307945116	3917635	5	0x15bae8f0e6d5f525403fac24bd589340317fcc72ca43350cdee40568b89ef6fe
2636	0x0000000000000000000000000000000000000000	0x87ae330d24590bcbddbbf62d3ecfe00ab7e9a530	95.736	20970036.472454461307945116	3917637	14	0xa522f10c5708cd294e911d39b3380519521e431ae0609dbb0cf98788ad0c9bf9
2637	0x0000000000000000000000000000000000000000	0xb13b808b38d04fdd951759234e0dc25a0e8a3026	389.454048	20970425.926502461307945116	3917637	85	0x309d580da1d19e8a7f937fdef1ca32956a053e41826d0e4b09f9ad9ec17f0267
2638	0x0000000000000000000000000000000000000000	0x6fc97c9abb1f8aa1a995d8ff41c9c0f6ef8a1dfc	95.736	20970521.662502461307945116	3917645	14	0x7a760c7d512a12e4ec647f0c98f4d7f9cad6661fb3793a79956ee12953458c5d
2639	0x0000000000000000000000000000000000000000	0xea4b8a63fdf64cfc2c500efe272bd506bc4d1c4c	239.34	20970761.002502461307945116	3917646	8	0x48cb2f2347b0c71d762db50ea18667e8b8a994df093be9c5a1599449d38909d5
2640	0x0000000000000000000000000000000000000000	0xea4b8a63fdf64cfc2c500efe272bd506bc4d1c4c	1728.523867356	20972489.526369817307945116	3917661	6	0xa38a49fb4fcd0bbe6c1eed26625006da943f80a42a22c10212967fed22112992
2641	0x0000000000000000000000000000000000000000	0xd0a7faf5648197a806458e16518a9cd553ab332f	813.756	20973303.282369817307945116	3917670	2	0xd927b682e0fac24b64aac9009eb08832f871eb481242078d9fcaaa46c413c79c
2642	0x0000000000000000000000000000000000000000	0x8f1af13f6639bc9fd05a5751a677ec6550291bb0	3829.44	20977132.722369817307945116	3917670	11	0xa06c8792351de18fce5d44cb769c528434557337b355583e76ce5020348432b5
2643	0x0000000000000000000000000000000000000000	0xfe236222e098bae7d44119f252cc8bb3b63deaa7	502.614	20977635.336369817307945116	3917673	55	0xd7b6c71bb11a0c52bad47ff15bfa11ee6ddc18339d6c2d875a3cf857da0de976
2644	0x0000000000000000000000000000000000000000	0xd352a59a0d9592baf54b40c18c0b8eaebdef969e	2390.97955458	20980026.315924397307945116	3917692	8	0xc0622499ffa77a69a35d21731f241855c5bde6423bbe339296a72e6ec8511de2
2645	0x0000000000000000000000000000000000000000	0xd1ab91a9875390ac6d656e93144ce21b97ab19c6	143.604	20980169.919924397307945116	3917692	32	0x8c10438a4d4bd2b1eec62e077407172112514257da5c0242be2cb1812164c223
2646	0x0000000000000000000000000000000000000000	0x527bd4a51998f9cc7246f2427f1ea5e1c4d4609c	2168.4204	20982338.340324397307945116	3917699	2	0x8b4abe1422e5b1241c4638a61a92848673fab850a648c9bdde66321fd1fd5f6d
2647	0x0000000000000000000000000000000000000000	0x8800411258c354cd74134369229b5fa2d33a6d08	239.34	20982577.680324397307945116	3917699	35	0xcfd969a1b12c9cbfe938ab7daa11261a81e08700c677deae727bf8250d910d94
2648	0x0000000000000000000000000000000000000000	0x9ad7a381172ec8cb864c97066966ae5c579eeed4	239.34	20982817.020324397307945116	3917717	14	0x11df35613e1e25c4b53d27d06d9f287ba821932caad2caf1cf3323a8fb027b29
2649	0x0000000000000000000000000000000000000000	0x9c2238e76e267912edb7817ce2c6e13468759110	595.0258019532	20983412.046126350507945116	3917719	54	0x2144bfdae66025a4c2ee5b4efcac40b057eff3e653bf06449204fbee42df1032
2650	0x0000000000000000000000000000000000000000	0x3ca8ecce0a9d750c0eede69b5c5982982952fd6e	478.68	20983890.726126350507945116	3917722	0	0x76952197eacbc246610a052e6c7d981aa4654e07e317ce6297efb54f3e93c907
2651	0x0000000000000000000000000000000000000000	0xc2f8f8c273284c20a54aa35bfc90f79209515103	239.34	20984130.066126350507945116	3917722	35	0xb80cef1c4b9fa7df5792c54ef146ac2487ce1fff4d94a44d079be961616eaea6
2652	0x0000000000000000000000000000000000000000	0x02203df183032281411ffd6f9f80bf1f53bd9fe0	1436.04	20985566.106126350507945116	3917735	41	0x7f3cfd12cf1b569bd140263bd7b7db5edc99088e89ed2cce99571aa37315fe2c
2653	0x0000000000000000000000000000000000000000	0x4b731186739844a761f09c6d2a4a89ad28623e5c	143.604	20985709.710126350507945116	3917735	74	0x79d9f9bd3443be1a6d42115c26c555bbd970114438639a45cac7d6e796253be0
2654	0x0000000000000000000000000000000000000000	0xd2a4cf7303508c68fd902dfe5cb8e20abab34297	675.17814	20986384.888266350507945116	3917735	80	0x63144931993e4815a690184005d47110c5b07c55853b06235119527858f0e10f
2655	0x0000000000000000000000000000000000000000	0xa8638085d18c050e0d7780e557a21b5e028f4d70	1436.04	20987820.928266350507945116	3917736	22	0x682d85c6aeaa3deab6d0e8dbcfddfbaaf580d8ecd179a70783ba0dcf9c9f71a3
2656	0x0000000000000000000000000000000000000000	0x78eabb0fa5e1827fec8dd9445266589ecc12954e	526.548	20988347.476266350507945116	3917741	101	0xcb7e0537668d8903f69d2cd5e22a87e6a73546968ec57c0fd1c8d94475255a25
2657	0x0000000000000000000000000000000000000000	0x817ad2c9024f4e3de0852ef1db0ad8588b40d7e3	2388.6132	20990736.089466350507945116	3917753	45	0x0f1cecd98f7feec7134c4c14705e92259b6f70e25c837b70fb3258612deff433
2658	0x0000000000000000000000000000000000000000	0xfbb1b73c4f0bda4f67dca266ce6ef42f520fbb98	476.76528	20991212.854746350507945116	3917764	45	0x4a7898312b949d7de39112c13ca1cadd6c4032c9c6c48057c9276b3df984e9fa
2659	0x0000000000000000000000000000000000000000	0xf82148ea0eb1c7635364574c018cb01d1411c6ad	478.68	20991691.534746350507945116	3917770	43	0xfe5dc8ae03e49468c7311e121d9eaa623b1ba68c084730c0a496d8514872ac92
2660	0x0000000000000000000000000000000000000000	0x76f82f6b2f3c5b562d9b3e921571cb73816a6f34	478.68	20992170.214746350507945116	3917770	49	0xf194f0e42b72c860c5cf5ac70f2a620c2f28969d8cfa957fedfc71ce437e7fd7
2661	0x0000000000000000000000000000000000000000	0x2024177a83b0d7657a11ebb3c0c3b561a89c62c6	1962.588	20994132.802746350507945116	3917772	55	0xa6bf516c70d5aed7659700139ccf2e1f8ecf3b04533f448d5339f2b35c3bae25
2662	0x0000000000000000000000000000000000000000	0xfdbc2f62e97842a8640783d8af26c0be169e023e	477.24396	20994610.046706350507945116	3917775	58	0xf37e29fcb0fa1a00c591dfc40bdaa569c9a0f1e817583c81430eeb4e4ae322bf
2663	0x0000000000000000000000000000000000000000	0x62ce46073c48a0385b7d4b5881e6fbfa4733c67c	14360.4	21008970.446706350507945116	3917779	30	0x6e4b4c5387de868f2d2a16842be0c3ca78226759ae148e47c306c79304de0db8
2664	0x0000000000000000000000000000000000000000	0x1fbdf165ae35c0382156f1876bab65632bd4ff41	2393.4	21011363.846706350507945116	3917779	45	0x2fb526d4e6201a02dbd49795e064368cf7628c2745e0c4a67893fa2231b6a009
2665	0x0000000000000000000000000000000000000000	0xaa4932b00412b29ecc630d6b26975caa2a584f3a	11.48832	21011375.335026350507945116	3917783	56	0xcdb641fa2b935ff38c3ec31111f5ba2c9a8dd6f02ca4d479c028b774bd875b24
2666	0x0000000000000000000000000000000000000000	0x6443bc90604456f9cac5b6dd720124d95460d26e	957.36	21012332.695026350507945116	3917794	45	0x16a633b52aa8b169248069e5c7bf286d25da07a6123851ed5ed116f449fd1d5d
2667	0x0000000000000000000000000000000000000000	0xdd223f941ac7c67b1110862f05e05d2f670cf7dd	9573.6	21021906.295026350507945116	3917811	0	0xbd819243a42e92a7ccfed4e596654727b5037e260883371d102dd23599d3c21a
2668	0x0000000000000000000000000000000000000000	0xb352366c7e95742e19b4ea3504c8105f5ba2600f	478.68	21022384.975026350507945116	3917811	60	0xf1674cbde1ebbca18df83e8d3f0d204b5ec8d872709578e5493e156bae08898c
2669	0x0000000000000000000000000000000000000000	0x390448fbaaa7a0d627005aa502e9970d8683e556	1531.776	21023916.751026350507945116	3917825	65	0x7cb589dda5133c1d86ad0f11a2f497ccf855c96491c11c5ea20790905f427537
2670	0x0000000000000000000000000000000000000000	0xfdbc2f62e97842a8640783d8af26c0be169e023e	478.20132	21024394.952346350507945116	3917830	44	0x7e8bd16e585716bf235dc1c70278f59cef76057c50cdc6c56b546faa7a618890
2671	0x0000000000000000000000000000000000000000	0x82eba40177cc53cec4ea8700d33c4af75f2a53dc	157.9644	21024552.916746350507945116	3917832	7	0x8ae9ada9152c42bb6a0e6bffd3dc5974427cdf4cf35dcd4315ac094cc6343b89
2672	0x0000000000000000000000000000000000000000	0x93916db9922e6fe08c25d4f415d0c7350aefed8f	2393.4	21026946.316746350507945116	3917845	3	0x2188e756bf3680c3619e43d2998bf3f281e61d2d9df663a8ab70ce06e9cee332
2673	0x0000000000000000000000000000000000000000	0xd91db5d2f3de1895d0750ec2cea595ace612c4c7	19.1472	21026965.463946350507945116	3917851	42	0x377b3f2446e22e09bab8553a09aecc01ef7effe43ec95dbbca5664cb8b19a5d9
2674	0x0000000000000000000000000000000000000000	0x5539960245adce112a9c90c9fe09e97fd17e4b33	957.36	21027922.823946350507945116	3917862	4	0x7e37ff58dec3c2028f464e01684c20738d096ca0ad8c64d8d257c0276832de4e
2675	0x0000000000000000000000000000000000000000	0x8337233db946c034802316b5c812a708f150b9f4	957.36	21028880.183946350507945116	3917868	11	0x95ad8e503408e03a234b2712a18b58852df92c188eda57f35f88805ca3bf1d5f
2676	0x0000000000000000000000000000000000000000	0xaa4932b00412b29ecc630d6b26975caa2a584f3a	55.52688	21028935.710826350507945116	3917868	23	0x95d29fdb113e547387d56713c1d74441df7eb767fd6f9015be428bf7ca77ca12
2677	0x0000000000000000000000000000000000000000	0xf49f8154adf80149073cc12e4c90b6289d1615e8	9573.6	21038509.310826350507945116	3917885	2	0x2d0f0f2ff0d05db93d8771c0e0a0eb62e7c6226ddc3ad9c8211651bd30ee8baf
2678	0x0000000000000000000000000000000000000000	0x821849f6a3c48b244fe0f3f9d30007708a2a3df6	1914.72	21040424.030826350507945116	3917907	38	0x946383e84404daf293ae03311beef9424568b698b384915aa83ec1a20daa19cf
2679	0x0000000000000000000000000000000000000000	0xa53074370ec38e1b0698fc5c5bc65708dc32d783	1436.04	21041860.070826350507945116	3917909	28	0x24e80fe38f390afec44c2e70cebded93039f5a35f3b57122cac81aec18d7608c
2680	0x0000000000000000000000000000000000000000	0xb1cf4fdea18b99fce068ca8316b87d425102c656	1432.468616388	21043292.539442738507945116	3917917	12	0x517ea9965864eabbd3a3c4fc0e80dfa963f714dda44163a76148d442d9904434
2681	0x0000000000000000000000000000000000000000	0xccc605e6a13e3cd53a0499523dc31ae0fe3f5dbb	143.604	21043436.143442738507945116	3917919	1	0x5da85da745d8e9c7602e33fd511b101b8f1e08ddf1661faadf1d7e89197b84ba
2682	0x0000000000000000000000000000000000000000	0x4528e34e92aafded02c9b3a7325ca338a3175aa6	239.34	21043675.483442738507945116	3917922	95	0x156092ed23f44457cd33ac223e7d1810ab7e195bf62b77d7467f3e0e56814854
2683	0x0000000000000000000000000000000000000000	0xfdbc2f62e97842a8640783d8af26c0be169e023e	157.72506	21043833.208502738507945116	3917924	59	0xec3c9df42f9e99c0bc719a908189d371f1a65f7dda2b0ddbceb74df229c27025
2684	0x0000000000000000000000000000000000000000	0x397ed45b48e649eaa8efb09e6047d82bf61ed3a2	9717.204	21053550.412502738507945116	3917928	2	0x70fcb0680086d375935f1450515765fb72c94b4705e8af4f1523383479f4bba7
2685	0x0000000000000000000000000000000000000000	0x40d1cb3e3f5224075970de8b9ed1d252497ee448	623.624304	21054174.036806738507945116	3917930	14	0xda1492de79dbafd2b3637e0cb20686dd862933fce6c4951fd22b1c1669dc1337
2686	0x0000000000000000000000000000000000000000	0x3c535a5e159521e6272c03dad1becce1ff0e88ce	53.899368	21054227.936174738507945116	3917933	0	0xc174736c1c57c38d5942b97ca98de079353b56bb5b2a730378a2e9afd534d9b4
2687	0x0000000000000000000000000000000000000000	0xc77de20f62ed4b0afa6683e2b11255be2000d7ca	67.876824	21054295.812998738507945116	3917942	64	0x6532807bd4b072e5a0f5b194e2344393fbdd2560ac40a4be100624f24840e7e3
2688	0x0000000000000000000000000000000000000000	0xfc615f53d3a53c43fe27c1841bfaf8cb3c3564df	1100.964	21055396.776998738507945116	3917946	1	0x37a6a7bb8167525e2968ab68486f91ef7e3f34e2e0dc91f4c77ee9ae6d3b85ff
2689	0x0000000000000000000000000000000000000000	0x040f225d40a289e336e5c28ed232b9e5c6c32a6b	478.68	21055875.456998738507945116	3917958	2	0xa28b2851564cbefab2a04dd3bb4d04f42541bfc0caa6241b385f92138380c6cd
2690	0x0000000000000000000000000000000000000000	0x82c7680cd5517e178ff54903af25c1fe0f04a331	957.36	21056832.816998738507945116	3917967	4	0xbad3d1d3b0e616c918b754f92451f8c8162451e6a0dc55bb3fbd3b064a391737
2691	0x0000000000000000000000000000000000000000	0xb1f6cade19e16087eb1178627d0111b90eb97345	957.36	21057790.176998738507945116	3917968	1	0x43dc841a91a9e0eb3883c9082e2592536110c84d09ea3335fa66652786482adb
2692	0x0000000000000000000000000000000000000000	0x4528e34e92aafded02c9b3a7325ca338a3175aa6	957.36	21058747.536998738507945116	3917974	38	0xf3b022421f46a7c1dd43390dc140d812a376303b15efe5f57cd782cd8a735d31
2693	0x0000000000000000000000000000000000000000	0xa1340ff337e79db5539c3755acbf17d3804313b3	158.27145838092	21058905.808457119427945116	3917980	22	0x8417c06058afdec32042d633e1cd9a7f9fa8efc159924032284007ac3ed48059
2694	0x0000000000000000000000000000000000000000	0x41538283f0cac4e338db29d96d195d7b8042b186	124.4568	21059030.265257119427945116	3917981	57	0xf583e7ed891994fed90b2babd1a192d386fb97a82c04c334d881d547ab238a22
2695	0x0000000000000000000000000000000000000000	0x68a36cb65de7d1680d73c0e929323a301b31bb4d	730.47338100384	21059760.738638123267945116	3917982	56	0xf5442166a4537129a9923b4d0d157b491d286828c6c0d8592f6dba6debcc327a
2696	0x0000000000000000000000000000000000000000	0xb8e5691bfe1f77b7a2032c6f156d6d93cfc17c16	957.36	21060718.098638123267945116	3917985	0	0xe99b3fe530647665535785decfa6bf7d49e68310874bcda1fa8f5bddf8e9f9de
2697	0x0000000000000000000000000000000000000000	0x97ab42ceb69cb8c524e1d31cb498241047726d55	239.34	21060957.438638123267945116	3917988	21	0x48e2226c80df347fbad886704315f8715aad840f3fcbd9b0ff9c0bfdf298e39b
2698	0x0000000000000000000000000000000000000000	0xe30c0cdc7ae455d92e4cdc72d90baf2a6e101106	478.68	21061436.118638123267945116	3917992	36	0x1c42abf296bf57535f5ac4e8c261cee573a14e45edbb6b8fd9ef2f82569abab6
2699	0x0000000000000000000000000000000000000000	0xb1f6cade19e16087eb1178627d0111b90eb97345	239.34	21061675.458638123267945116	3917994	3	0x86dc8899fc0641de6ecf85ddcdcc9ca4dab4bcb3b5bd27b6e617515621f653bf
2700	0x0000000000000000000000000000000000000000	0xb13b808b38d04fdd951759234e0dc25a0e8a3026	1.43604	21061676.894678123267945116	3917994	41	0xd20909801738f16d52910b3feb9bb220eb4db0e3d69d46291f5e0282eda33ed1
2701	0x0000000000000000000000000000000000000000	0xb079a72c627d0a34b880aee0504b901cbce64568	2393.4	21064070.294678123267945116	3917996	33	0xb6f952328f8ceaa92828752df10c0337c953c42a7f74480c119ff9d9d009f63f
2702	0x0000000000000000000000000000000000000000	0xf49f8154adf80149073cc12e4c90b6289d1615e8	19147.2	21083217.494678123267945116	3917999	30	0xed9dd2b41c67c93eedc1a91b938592d5fc5aadcb4d8b8f8e7911b2d7ed02a470
2703	0x0000000000000000000000000000000000000000	0xaf8d03c2bc2409edbb14c975235f417fcc9b3efe	478.68	21083696.174678123267945116	3918009	4	0x776b47aeb634bdab55483a0782d17af2b1a4dd801bbdc8fa9762bac4e59cd625
2704	0x0000000000000000000000000000000000000000	0x77397df3e334849bc4e35dd20d7e71e8595b7b4c	239.34	21083935.514678123267945116	3918011	84	0x6109c8d6cc54d04a2dc3605bdcee9d36df661bfecff35bba1aad5f995717a9c5
2705	0x0000000000000000000000000000000000000000	0x59ba25503847c1ff63a120a613b6ef21045b7e55	2393.4	21086328.914678123267945116	3918026	50	0x9f06d85d27fac2ae409f04dc235a4447151a03ab1e1e82ef22736b8fd4a13ad2
2706	0x0000000000000000000000000000000000000000	0x5865c90dc62ee5c5eb02ae3fbf778e335a4b8772	1627.512	21087956.426678123267945116	3918026	86	0x05d940e6d366f2ce8cc214ace620c37dea06be3073c15397806721229fbc673c
2707	0x0000000000000000000000000000000000000000	0x7e32268e3f95d27540359305b407a27284fe9772	143.604	21088100.030678123267945116	3918044	22	0x3d9db721df0a4deb77afd7a20281fe298d9aeb9a49b76b950b2c512fa4bf3dff
2708	0x0000000000000000000000000000000000000000	0xbadde89fccb038e9b580b7b6a5580808a4e76a44	47.868	21088147.898678123267945116	3918046	2	0xa2fec8563f141f0691b4daf9bc75d7c7344947f765cf2f566585e2fcd36ac701
2709	0x0000000000000000000000000000000000000000	0xb504d59519800b88f51b1e0c7972e652802efe32	9573.6	21097721.498678123267945116	3918059	21	0xf848124c0c6575c16a4fe56882d0a2cddbd5f8fce0e141058f07feabf37d54df
2710	0x0000000000000000000000000000000000000000	0x137a178cc813d559046398bef7622f9869768592	947.7864	21098669.285078123267945116	3918067	0	0x982975b59f15b4af316574eee5d734ddf28cfc352163d0156dafb666ec4dc250
2711	0x0000000000000000000000000000000000000000	0x477bd7ad22895d45424d65d8807894280ecdd804	7.1802	21098676.465278123267945116	3918075	8	0x635b427ac115a7f6ba0464c6ef7ec679376d62dadfa0271eaad1c3b0632e8adc
2712	0x0000000000000000000000000000000000000000	0x0e9571770f5e81cb9b9a4ae3b8b7b56757a4bed9	1436.04	21100112.505278123267945116	3918088	6	0x279a28da04854cbb024bc5324e3afe6cb65bfe64cb648c449304b38dd5ae815e
2713	0x0000000000000000000000000000000000000000	0x477bd7ad22895d45424d65d8807894280ecdd804	23.934	21100136.439278123267945116	3918110	28	0x91d93b9c4ed9d5caba26e17074fd25052611ec04684c8616ab086bbb75282278
2714	0x0000000000000000000000000000000000000000	0x0e9571770f5e81cb9b9a4ae3b8b7b56757a4bed9	1914.72	21102051.159278123267945116	3918120	25	0xb6e8aa6bc491dba8c6da8b3fc59bf4b5ad5593764a07bcd4367d848fe05a06fb
2715	0x0000000000000000000000000000000000000000	0xb12546b9552bc57dd06bf2bb259de0595322246d	1713.6744	21103764.833678123267945116	3918126	36	0xb11fec2d3455cb6236011c9f37932077b8b3b585b507820b3c36b63b5c5f1efb
2716	0x0000000000000000000000000000000000000000	0x6efa0137de994ae89d42d6553cbc338e9b0da970	957.36	21104722.193678123267945116	3918132	47	0xd3ec187f633a2211763ee9c5b81bbb30e1f4fb5b2d8f81c9d81710a4981c3a81
2717	0x0000000000000000000000000000000000000000	0xb504d59519800b88f51b1e0c7972e652802efe32	9573.6	21114295.793678123267945116	3918138	34	0xf81e37e4ba33d9926de5642be4abf5b3cf4e19230c34b560aac67d62ae9b66ea
2718	0x0000000000000000000000000000000000000000	0xa2330287a902396d892c5895b7f8a8a4c0b94307	478.68	21114774.473678123267945116	3918145	3	0xa308df72786908c521b19605fa59524ea48bd67a7dbe3f4647fafe5e4aa06fda
2719	0x0000000000000000000000000000000000000000	0x2f46baf2f8210c4509991c1382c8c31a1d171d0d	157.9644	21114932.438078123267945116	3918162	87	0x3026cccfca62fbaf0aa19de5ea3a0b8862ecc19416754152f25aa7a8bde69ddd
2720	0x0000000000000000000000000000000000000000	0xa53074370ec38e1b0698fc5c5bc65708dc32d783	957.36	21115889.798078123267945116	3918162	88	0xfc2958041205257faf9303e3dfd835900735e2a0e0db3709099d8dbe93354276
2721	0x0000000000000000000000000000000000000000	0xad4ecec26aef498949e7ef64cc54372f1de52e51	1436.04	21117325.838078123267945116	3918167	0	0xd79a322879e8a78f0d9e182b1e93b083faddc499a72d1c9e3e3588a7d302f75e
2722	0x0000000000000000000000000000000000000000	0xba9a7bf08aad49e3c46a6a9cef85ecc42b0b1cfb	577.76676	21117903.604838123267945116	3918171	4	0x3039dbc91db0b27d831b0b2faa957b4395b281880c28239f5ebdf544772b76ab
2723	0x0000000000000000000000000000000000000000	0xffff974baf71165c175a64cafa367c91153f9371	95.736	21117999.340838123267945116	3918177	26	0x8ea49e8b5e22cbc9e7107e21386d32a314e558cc0433aa58ed080e94748b8a78
2724	0x0000000000000000000000000000000000000000	0x1f3c60d9c5bf30f44d666942986a62f513a6260d	196.2588	21118195.599638123267945116	3918185	1	0x152429238246056867b29d6b909ec5a29e8fcd2fc0e973a8747e2ad04985cc19
2725	0x0000000000000000000000000000000000000000	0x3578704684bf0af16e35bc8320402f551a707647	957.36	21119152.959638123267945116	3918197	74	0x6369533cc5f35140cbbc2665add452c82a7ca1155f31d9309ffe04ce3e64d9bf
2726	0x0000000000000000000000000000000000000000	0xafe32f7a261f6b5aa9ad251f3bdf0090cbd6c54f	4786.8	21123939.759638123267945116	3918198	52	0x93d6483438e14ab5900ede6f1b87463307cdcae98fbdc761cb36ade957caab0d
2727	0x0000000000000000000000000000000000000000	0x4f3f66920d2321b5c51ae379cf1a243405dea1ad	957.36	21124897.119638123267945116	3918204	21	0x6a71724327a5a76666cd2537aabe5aa7942291503fa4d540e805e7dd25703c7c
2728	0x0000000000000000000000000000000000000000	0xabc086583005f03b6b2ad22c46d1c9129181e061	957.36	21125854.479638123267945116	3918211	1	0x9a6be6464773a086fb5d589d99bd434179fb63dd9d08c0a28b6a7f2a51ec82c5
2729	0x0000000000000000000000000000000000000000	0x53f3406d495ba4e37088975079492a634becac53	426.0252	21126280.504838123267945116	3918218	5	0x654011d05c86c9df7ab862df0a5388d82bf3c15f08afc44a9e849a1c64b40174
2730	0x0000000000000000000000000000000000000000	0x1ce74034875a0534cdef5f14fca57f326f312a64	478.68	21126759.184838123267945116	3918218	30	0xcea3aaea1b7759e2898e7e66e4583445fbd6953ea9fc5b0318298be429bf424e
2731	0x0000000000000000000000000000000000000000	0x7cbfd338198174adc8a8d37b7a9c7d86e9093a4a	6222.84	21132982.024838123267945116	3918223	61	0xa5913a7f027ef0f3efb813936abf4a09798ae0815660fbc0c1dc358f3597816f
2732	0x0000000000000000000000000000000000000000	0x6c7de97c801bfb1503d2a54a9bee702aa05163b7	526.548	21133508.572838123267945116	3918235	42	0x5ff381e3c0d5fac45c37d8da3403f003e88210fe180b60f275571af3dd6e2661
2733	0x0000000000000000000000000000000000000000	0xf1cc647bb15a5ab7667feff7e7c80914374589a1	478.68	21133987.252838123267945116	3918266	27	0x1c59a12eb4cd0dd8027c624456a10bf8f7d437d40b4893844b489a0dc8c04cd5
2734	0x0000000000000000000000000000000000000000	0x6de48a79fb151e802f017f63df2d1e7d934937b7	1416.8928	21135404.145638123267945116	3918268	10	0xbf40e61c287dd9011c9dfe60ab84a76185552d16cb6f191682d80cefcc2242fe
2735	0x0000000000000000000000000000000000000000	0x0e8d425ee54e2b3cdd99f51088cf391b675d7aa8	2393.4	21137797.545638123267945116	3918270	19	0x4722ec5aa537505044662ee3029eee684593905a654dd711fbb99bb1cc583894
2736	0x0000000000000000000000000000000000000000	0xab3737eb42e4b6e9703ec1d70aef7d4a00c2bdcf	622.284	21138419.829638123267945116	3918280	2	0x9daf50af29250b2a1cb40373446adf8a4d6ed1bef3da7fe918f66d284671dd21
2737	0x0000000000000000000000000000000000000000	0x321769251b3af9ccdf23f77a231bafb95aadfbff	19.1472	21138438.976838123267945116	3918283	27	0x3b344bca15ad239bfc49a4a9331ea4b1beee2418a1f4388fd741abaa51af0ac3
2738	0x0000000000000000000000000000000000000000	0x26599f3acdf67c0065de28e6890de2c37d209bfc	2393.4	21140832.376838123267945116	3918311	3	0x32dd3166f68ace2e91050d48a48dff4a3584313e3748ac35bb75e52ca09f5313
2739	0x0000000000000000000000000000000000000000	0x62fb600ffb5b3d2f50caa138e5bcc49b824ff398	9573.6	21150405.976838123267945116	3918313	9	0x09d3639e5d334739aaf66a19b6e92b1aaa531e586cce0d466f36253974dd26a9
2740	0x0000000000000000000000000000000000000000	0x965b28b43abd85e27e6746909d051579cd4cf74d	477.832844103	21150883.809682226267945116	3918322	15	0x9e00c354d2e5f53aa818d5161ba0787f0dcb255eaa82907ed19b50191135dbfb
2741	0x0000000000000000000000000000000000000000	0xad4a86de33c3a7846e11826dcea139496a4d473e	502.614	21151386.423682226267945116	3918326	10	0x82017bace38ecace7153e4ff50675dade95a573215d7bfcbb080b07f9f38a6d3
2742	0x0000000000000000000000000000000000000000	0x04d3b35b8797adbce34444b256c9750b93ae147b	1914.72	21153301.143682226267945116	3918334	24	0x299624dc882e694bc1ff89373da7b3bd1054bd4dff4bbd4bc7f06fc5c6cb93a0
2743	0x0000000000000000000000000000000000000000	0xb6d72259cb2820a9d9d05ceb21d038584794f152	1914.72	21155215.863682226267945116	3918356	4	0x6a565701bb617c84d1e0aba1a1ea95d5edc4c6c8976fe5891108757bfefd55be
2744	0x0000000000000000000000000000000000000000	0xe0ecdc71d91f9f89cdbc0debc763d48b392947c7	477.832844103	21155693.696526329267945116	3918358	48	0x78293e297f82ac3e02aed4cbcb046f635bd2b668b8851189903b0c3addbbba23
2745	0x0000000000000000000000000000000000000000	0x6bfa43a195dc002e6f804610beabadca9f11825b	478.68	21156172.376526329267945116	3918361	7	0x66bd5c238eb6c224b33adf37e7ad5f4e44cdb3c34dfc3541ba499aa2b6bef7c3
2746	0x0000000000000000000000000000000000000000	0x73ec7a81e9c9a8bfac784e1cb8052ce693a78cb7	47.868	21156220.244526329267945116	3918367	54	0x34659f242d16eb11030ae22bef5d75ab7b4b0621833045d5b36f3ac343045523
2747	0x0000000000000000000000000000000000000000	0x5077903e7f4349554d74654049f386405552b614	478.68	21156698.924526329267945116	3918368	23	0x1541ff4a8f2ec4bd1102188d6e2d338c0e8a450ccdfa064b66f2ec2d65fbb479
2748	0x0000000000000000000000000000000000000000	0xad4a86de33c3a7846e11826dcea139496a4d473e	263.274	21156962.198526329267945116	3918368	25	0x8ed6adb90c0a25cfa1c0d9cd590d5df828eb00341de87df7f93319ef3d5185e8
2749	0x0000000000000000000000000000000000000000	0xcd972c28e9a6b1e091d220c4d6104d1a7b867ed8	239.34	21157201.538526329267945116	3918370	69	0x10c9ea1a8a7e430cca6db680967edde52e8e2ff324209fb76557492338927a49
2750	0x0000000000000000000000000000000000000000	0xc3c49986505cd7073a48c9bec230594e91cb1ca9	239.34	21157440.878526329267945116	3918380	12	0xc24738539c4535359621096ebf5d30beddcf9fd4dc1adabc6fd27715a74eb06c
2751	0x0000000000000000000000000000000000000000	0x2e67fdeac5e21007f2e55f40d06650554441442f	478.68	21157919.558526329267945116	3918380	45	0x12fabfae7ea216f96d007c089a42aceb92ba975c75a576830f1e45206eaabeef
2752	0x0000000000000000000000000000000000000000	0x3aa44ddc54f9ab8e82c0a457035097f53c864178	119.67	21158039.228526329267945116	3918391	44	0x3d6aa9e3e6d3ba1c751a38fc3438ee6b6d5fdab45a64cbea2780a3b8ad19bd19
2753	0x0000000000000000000000000000000000000000	0x752787eed164651e282f311530d8df133e006f04	785.980777366983518062	21158825.209303696251463178	3918392	89	0x4634ba476eb4bc64c1627f3f2692a059121fed1fe06b3d23c62ac89a6a4919a6
2754	0x0000000000000000000000000000000000000000	0xc411161a8b24eddc670a0064faf2d88a64d73d91	516.9744	21159342.183703696251463178	3918393	4	0x3b96d383055aec2dfeb5fe0bf803d31ad7aebf5fc1d565e3fb64772d8f169bb2
2755	0x0000000000000000000000000000000000000000	0x5290fc96fe34ed4d2a4d9d39e7737d9a3fc96a0b	798.1208943072	21160140.304598003451463178	3918398	10	0xfb8ce1c52096fcb8241636ff5ef56745803e6419085f7b33361085c3890fbeae
2756	0x0000000000000000000000000000000000000000	0x9af816a3923ce82352100b52b1695f831347c66a	191.472	21160331.776598003451463178	3918403	48	0x1dd5e41ed4cc89b91c0edfa1737b1281a9fa2c4ab4c5aa2b23619d8605c15d5e
2757	0x0000000000000000000000000000000000000000	0xd165e857d6228aa40f36aaa055251cbd949cc2b4	3567.2581419276	21163899.034739931051463178	3918409	6	0x86aa99de14e21bca49064492cae4995e9fe4e8e2364cfa4529ae773b5cb4ab15
2758	0x0000000000000000000000000000000000000000	0x390757afa167e7c86653e1d7cb0578a8757e7c09	396.45023766384	21164295.484977594891463178	3918409	31	0x5b9e5cb1baadde7534fcc33af9d4c5e5ae71338580da0a923cf73bac6f5bd96e
2759	0x0000000000000000000000000000000000000000	0x4fdea21c24b775ab8288708ee6ba31299d829602	5744.16	21170039.644977594891463178	3918455	21	0x8bccbf4295f217d03e4f49b46f9731680a69b9e68de4290be277082938be03e9
2760	0x0000000000000000000000000000000000000000	0xb6d22ab9bfa6b22df9e3f1d74fc7fa615386be8b	3350.76	21173390.404977594891463178	3918462	51	0xeb6c87ab2d06f8303615475fb54832c5c4b4596d33f2891ee9db49433461bb25
2761	0x0000000000000000000000000000000000000000	0x08de5f9228d8714d46c87e2ebbcae941f7b4b55f	157.9644	21173548.369377594891463178	3918474	25	0x281aacd7a39b43e44386cfdf510e4564b868c7ab105167444afb86e0e710e839
2762	0x0000000000000000000000000000000000000000	0xd84fdc3e06c14264932b182364b657c5bf168d1e	478.68	21174027.049377594891463178	3918494	9	0xb930591d08ec3491f21c1437004c9d5aae89e5a9bc9207ffe96758c96c10b84b
2763	0x0000000000000000000000000000000000000000	0x0977a13ed04aca10ded7f69afc5e673988ce7b04	2393.4	21176420.449377594891463178	3918507	4	0xba31e6e8d39207a26f1ccac0941d7ae7010fd751e74f9f3af10399328aa4fc87
2764	0x0000000000000000000000000000000000000000	0x9e3ca06de4ed1ecd4a6f21e1a2cbac534c667fa5	234.5532	21176655.002577594891463178	3918515	1	0x3d5ad52dbe5463c164c1e74d5a3b211bde5b0420afe6a97de59f3da826f6bfa7
2765	0x0000000000000000000000000000000000000000	0xfb4c47e2d80bf8d9ba732f374cb7cb9e38757896	478.68	21177133.682577594891463178	3918520	92	0xc44b1bbce68936ddf97fb77bbae679fca8adf6313574e256da7633511ea6d904
2766	0x0000000000000000000000000000000000000000	0x3a3e475f856395db3f180230f480b747d99b738e	478.68	21177612.362577594891463178	3918523	21	0xd75e51b1af26e81d957da7d9ccba14cda6d0c08bb4f2deaae243b7dfb28fb0e7
2767	0x0000000000000000000000000000000000000000	0x7431bbec239c189e57fed6f548b396003e047947	957.36	21178569.722577594891463178	3918537	64	0x3043dae37cd9b907522d70d53574b3ac08c2461a6f200f44a6cb2e20df918416
2768	0x0000000000000000000000000000000000000000	0x6289e3b360c40025f231bbc24a294231c5c7df5d	1196.7	21179766.422577594891463178	3918552	7	0x2bf078bf52de9bf7fc9a033b2a4ab41fc61d35b3936afce8f50cc6e606611088
2769	0x0000000000000000000000000000000000000000	0x7431bbec239c189e57fed6f548b396003e047947	957.36	21180723.782577594891463178	3918558	42	0xb17a8fc2c7fa4b8855c2413ea26d9af82f25e52862d410053a9f27bb8714713c
2770	0x0000000000000000000000000000000000000000	0xef055ef99eae598d62d88c3383d3d8b61d75a6dc	167.538	21180891.320577594891463178	3918571	58	0x8e15bfd1b867cba2a4be8e38e0664da78f1e8f09563a1c28c3b7d2986608d812
2771	0x0000000000000000000000000000000000000000	0x9c96b377ace3f98cad190c08a11fa4fb11684442	430.812	21181322.132577594891463178	3918586	45	0x834024a61d6ff2a055ace961f27628797b4c2e38d07b6bfd434fa51965a71ded
2772	0x0000000000000000000000000000000000000000	0x4bf032c202fa8379ec1d2c400289a6d8d36963e9	478.68	21181800.812577594891463178	3918594	18	0x7746d0d58a8f7347eb5b3c074b132dfb49c609886d8168ba778f554a44193f62
2773	0x0000000000000000000000000000000000000000	0x691f076c4856ff869a9638ef8ce7f6b1871113a2	143.604	21181944.416577594891463178	3918605	1	0xd27b8063b23999ed6157f25a82fd0d015a619665c4fdad980f535cfbd994aa0d
2774	0x0000000000000000000000000000000000000000	0x4d364ce5c09d5995a07a297cbc5e4269bc3c6776	1005.228	21182949.644577594891463178	3918608	96	0xdbf62801153de07a7291543d02ac758b1f9ba0e7a27f8f999ba6ab2643d23f84
2775	0x0000000000000000000000000000000000000000	0x167464f95479c402bfba7a254a9bd75064f8d05f	47.868	21182997.512577594891463178	3918609	90	0xa2ecae235e6a571243265c1a9f0bcb5c9d6ac0adcb1a34c96cebc7d4c4e50c54
2776	0x0000000000000000000000000000000000000000	0xfb42374c8ad379b9b6ba4e25515b76554edb960d	574.416	21183571.928577594891463178	3918617	35	0x3d404eaa1b642c727fa6d98d1073b5cf2961231e45576ac3f7127a7e7438344a
2777	0x0000000000000000000000000000000000000000	0x4544451c39b3ca161ec5662e12a97aeec4ab753c	478.68	21184050.608577594891463178	3918618	73	0x16e4baf033e7de93a93d197ad753b56a3f564395ec4ac3785d3d9abeb426d9ee
2778	0x0000000000000000000000000000000000000000	0x167464f95479c402bfba7a254a9bd75064f8d05f	478.68	21184529.288577594891463178	3918620	26	0xf32d0a26ce10ce879f6b205dcc5b1f0b95e6ee08d09e8ab456f50691166414a5
2779	0x0000000000000000000000000000000000000000	0x4f2b1f63e22cc2b0fc56837816e6eaa7e1320b1f	478.20132	21185007.489897594891463178	3918620	34	0x48d8651b0ea33a978ebd74ad86db84f7ec107d4ac400d46282d6bfa9fc8bdaec
2780	0x0000000000000000000000000000000000000000	0xe541557de2a9e21b98159260ce8f0658cdf82516	167.538	21185175.027897594891463178	3918625	7	0xd3846e5048db8a6bac4099862d815e7654ed094b069c773547b2d86c73a31bad
2781	0x0000000000000000000000000000000000000000	0x2445c3bc5c3956b6cb7593143b2351a059ca8a03	473.8932	21185648.921097594891463178	3918625	8	0xdac4a034541049945abea0ccbebd00e30881cb5634a248450eb69e9c7e7c12bd
2782	0x0000000000000000000000000000000000000000	0x40d1cb3e3f5224075970de8b9ed1d252497ee448	4.691064	21185653.612161594891463178	3918628	33	0xd33d572364cf1cf70e446608bec220d84f6da47a512b25ea97bf264ae8af28db
2783	0x0000000000000000000000000000000000000000	0x167464f95479c402bfba7a254a9bd75064f8d05f	430.812	21186084.424161594891463178	3918631	23	0x986657568c3931082df5e77e92dc595af3e7402241d24de7c810f02dacfc6c8f
2784	0x0000000000000000000000000000000000000000	0x80cfb5e01e32f415e78eaf91932772094a8a8e29	1436.04	21187520.464161594891463178	3918637	60	0x59a6179a45b3ff31961e518a4c032507e308701a105e5b8b33ffb19f2f3c8634
2785	0x0000000000000000000000000000000000000000	0x0bd0d3a307d0483506c8b508252b2c9666224d5c	224.02224	21187744.486401594891463178	3918638	9	0x82ec8cb03be48a84f23549403c872dacd65d7b289a0e6bb9e426c5496dbfed33
2786	0x0000000000000000000000000000000000000000	0x328a319b715b7dddc0543914a0f61189effee734	893.14412064	21188637.630522234891463178	3918667	26	0x26d30a0e813d0942797c139e9b9a364ac1a6a2a2730304cfa6f0182cd043a70e
2787	0x0000000000000000000000000000000000000000	0x132a100f171f17ac6914464b4f00bca25cb99aea	239.34	21188876.970522234891463178	3918676	40	0x6dfd2c4b8375fdc3f437967fb2ecf114d3a80fb609ade723a7f676699bede190
2788	0x0000000000000000000000000000000000000000	0xa145f31657d5a92c41338fd628339feb8e385219	1436.04	21190313.010522234891463178	3918679	0	0xaacd34257a5d62015a92cec098754d5a7fb9a2e942b9e8f5639885934f817c81
2789	0x0000000000000000000000000000000000000000	0x334124c0c9e7ca3c6bb98007a605bb67062f01f2	28.7208	21190341.731322234891463178	3918684	13	0x3ec00eac5e433660e6e512cdcbcb01d9bee0e284b177f607910b4cd0be157d66
2790	0x0000000000000000000000000000000000000000	0x9e3ca06de4ed1ecd4a6f21e1a2cbac534c667fa5	210.6192	21190552.350522234891463178	3918686	6	0x88d68beccc408b815dba49d28c48f9f24fb2e8cbd69e18c325623604aa8044a8
2791	0x0000000000000000000000000000000000000000	0xee4251abd5b0242b091aa568a2826eee55670416	1914.72	21192467.070522234891463178	3918692	9	0x8ce66a6c74a5dcabcfbb7944d1fcae2ed8c80e7c99dcfb1bae1a9cde51b17a12
2792	0x0000000000000000000000000000000000000000	0x3d5b70d926281ad1e3e3e3ef9e94cc06a7921db1	149.4681746496	21192616.538696884491463178	3918694	2	0x97d6306368eb637956fc8e2599ec5f086a5ac101be4903be017bb51579cad5c2
2793	0x0000000000000000000000000000000000000000	0x5fb552c6ea8a0b4f6b635e8ee0cf45ce32c0874b	44.03856	21192660.577256884491463178	3918697	42	0x1e3c986167e6f411d477cee4ff283f5c48810cdece4499dcac3242a54b1dcaa8
2794	0x0000000000000000000000000000000000000000	0xaa5a36536261f409c106a4e4862554772a4daad0	478.68	21193139.257256884491463178	3918708	116	0xa30df5e1c6ce1fcb2c09db54e27ca88cff0462b25ed8d3d1c54ea56bb935d161
2795	0x0000000000000000000000000000000000000000	0x05f952e0e8c6906d38b90e9bc8b8a2b7eb738ff6	478.68	21193617.937256884491463178	3918713	28	0xcab2edde7c125281aceb3077aac7466e8c4b54e0067c2167b3b9a7096f286c3e
2796	0x0000000000000000000000000000000000000000	0x3162db4486cb3513e30214aa8c841b57f33fe3a9	856.8372	21194474.774456884491463178	3918719	38	0xf45b029fe505d2ee2c0c7ccbf78b6f0ea3ee43d5ef8bc147d52cfe0283cde173
2797	0x0000000000000000000000000000000000000000	0xfe17224c59d17a4315be068211e66bf4a5194c1d	29.19948	21194503.973936884491463178	3918723	3	0x410fd4af784af198305fc0519df8b030330ef0bdff92a3bdab34320d3a7dd02d
2798	0x0000000000000000000000000000000000000000	0x7d753f05e81851add2e14727387ec0a7c2ff88f3	86.1624	21194590.136336884491463178	3918725	30	0x022d863bb152eb4c39258064fdcf293650a6ad2ca97a0e79d27b1db763e9f035
2799	0x0000000000000000000000000000000000000000	0x619ac409f634fb90b5a6dee498b00abd2c4db52d	1450.4004	21196040.536736884491463178	3918767	20	0x96e2eaed5c5d4a159b763c713f6922c98edf3f481c2b2f747ff61b72e8d935d5
2800	0x0000000000000000000000000000000000000000	0xad5698f7e9f27bd07d2331886df2321fd0f68f83	67.0152	21196107.551936884491463178	3918772	2	0xe6099e58d10c1609cd790a73640cbe1f5775aaab94509a27f712142dca8f3dce
2801	0x0000000000000000000000000000000000000000	0x05f952e0e8c6906d38b90e9bc8b8a2b7eb738ff6	478.68	21196586.231936884491463178	3918773	6	0x89a922c82b63694337d0c90cbd4041489656ac3dab835539e62dc5866b4ff706
2802	0x0000000000000000000000000000000000000000	0xc3b024cacf8370a8eac010b7c33d1e6298f193b6	622.284	21197208.515936884491463178	3918778	40	0x42e359626d7952e470aad385717dd886a2860054ae5663eaaf8202a1ba621d06
2803	0x0000000000000000000000000000000000000000	0x3eebfc3a6a03b4114013be679cfe36099dfad29b	143604	21340812.515936884491463178	3918785	0	0x129d4493ea429a6154870d1740f12d25f4bc26f792bcffad0a8daa191e82ce84
2804	0x0000000000000000000000000000000000000000	0x3baaa2cf6ade22acf2a487b37b86b3a50593f4f3	1005.228	21341817.743936884491463178	3918790	10	0x5a924e1fc4c3f5e148550bad7944d5e57a6fd6d4931aafd600ce56a941473729
2805	0x0000000000000000000000000000000000000000	0x96845d0b4870ed286fc45068a42de993f92c7208	38294.4	21380112.143936884491463178	3918806	0	0x0c403daca2825b93444dfcf48359cba6f82200e7021d79b70e68c80ad06fb3c6
2806	0x0000000000000000000000000000000000000000	0x1d3f4eb1bad05fcc6d633d51a9e264a69fd7fbc4	478.68	21380590.823936884491463178	3918813	28	0xa77bd7e11a4d691bf07d4e0576b1c3427f54dab59b8868fe90b5d5dfe4909ab9
2807	0x0000000000000000000000000000000000000000	0x24896b0180d6a33fb5205c9cbf72e65a4f762c9f	526.548	21381117.371936884491463178	3918831	3	0x450c0ed1bb352ce2af9d530475421cbe6ed60f82cfb13e1533aad5cd4b2b390e
2808	0x0000000000000000000000000000000000000000	0x1d3f4eb1bad05fcc6d633d51a9e264a69fd7fbc4	957.36	21382074.731936884491463178	3918847	42	0xe5ce02945d1587146f7d45fb9fd4600ce53e71dfc2664b7024f68d9d8047de8e
2809	0x0000000000000000000000000000000000000000	0x24896b0180d6a33fb5205c9cbf72e65a4f762c9f	430.812	21382505.543936884491463178	3918859	4	0x869fb4860fb7e6706317cea09a0702f9313837607de5d64845bc90aa38e00f0f
2810	0x0000000000000000000000000000000000000000	0x43aa0364909b44361bb638b315ba48cba00a764a	1196.7	21383702.243936884491463178	3918873	9	0x1a308434231d683a4c8c3f0ec8b729d4d5b7e9fe87f649e447c00746eaa482dc
2811	0x0000000000000000000000000000000000000000	0x6ddc6019b8ac143efddbb15eecb9d26d44283318	574.416	21384276.659936884491463178	3918879	20	0x488dcdf669345029d10208ca401edba40a2d56fd7c75ab7b939be570a18c43af
2812	0x0000000000000000000000000000000000000000	0xf5e6574f9f2c12d4a2e4fc1d6d5c4e76e10644a6	47.868	21384324.527936884491463178	3918899	2	0x61623549299ad0c3aad9b1893ef62cfd7b1a0507a9ae5d9d2c74f0c7f8735261
2813	0x0000000000000000000000000000000000000000	0x929daaeea12eced32768ae8ccf1b8123d49de7a3	981.294	21385305.821936884491463178	3918899	6	0xfd7956ba15b9423de74c5f646258b519244975d0223c12f3319c67a6acdd7d47
2814	0x0000000000000000000000000000000000000000	0x92e582c013dd179813c04fef7ca0283ee3397ce0	2872.08	21388177.901936884491463178	3918924	14	0x0faaf08d810a2a8acf69be80f96f70c18eaa850e6d6b9e1d6f9ff294b4bfa6b2
2815	0x0000000000000000000000000000000000000000	0xb24f30ee924dc28e31148c72a180bac610c9e232	47.868	21388225.769936884491463178	3918938	34	0x04f56de741a763e1fafd020c0811d83228ba55a462944c2fb320071d49a82ead
2816	0x0000000000000000000000000000000000000000	0x469d6b2819d2040c853251281df0e46f932d789d	478.68	21388704.449936884491463178	3918951	15	0x987a792a71ee0dbf992dc57407f2b443be9617c4dca90dc0cf388fb6f4b2d1d0
2817	0x0000000000000000000000000000000000000000	0xb24f30ee924dc28e31148c72a180bac610c9e232	430.812	21389135.261936884491463178	3918951	38	0xa4b5af3b0b00f33122912a985e9d6197bfac49c06b375c54f64ec643fc8b5436
2818	0x0000000000000000000000000000000000000000	0x2cadafe29d2b53b990742ccb2285e9dd9d6de037	478.68	21389613.941936884491463178	3918965	2	0xe3c238433863c4acab51df3563a5628e9a3ac0b06f840b2590046cc253d77994
2819	0x0000000000000000000000000000000000000000	0x95b422e81a4fe97d4c490ff57ad8ef3d1a5b5832	12924.36	21402538.301936884491463178	3918974	31	0xb3055b347db9cbde995b72ec3af9f83a3ad3c69aeaf0831cfc0837bf7a8a764e
2820	0x0000000000000000000000000000000000000000	0x267be1c1d684f78cb4f6a176c4911b741e4ffdc0	55.0482	21402593.350136884491463178	3918991	3	0x9b6423ff3d148bcfd141c2ad8dee17657c6ccdedd8b4ce3e169563bc63a41728
2821	0x0000000000000000000000000000000000000000	0x26026dcd7c43a3a8f4c1d1589a6933715400882f	84.24768	21402677.597816884491463178	3919001	19	0x44e2c37e328e32a8e5aa6be2b03ff2f702a39ed1c63d8967b2b0b196c098bdcd
2822	0x0000000000000000000000000000000000000000	0xea56152d94d6dc1d69c90e1bb4a2ef8c79d4d49d	923.8524	21403601.450216884491463178	3919005	2	0x2828b6fcfefdc19633a6a845bf2f15a89e0caed3047f1dd81f885e689bcb1ab2
2823	0x0000000000000000000000000000000000000000	0x24dd7871dca2b239a442bd997aadfbe6f11b9c03	622.284	21404223.734216884491463178	3919012	17	0x70452a4275ae611717643440e0abfff2a4167d0e6f688126fe65efa044ae631b
2824	0x0000000000000000000000000000000000000000	0xe8c8c4620980bdbb2c214fc876f99242c58de1f3	2824.212	21407047.946216884491463178	3919017	1	0x79e91a1e4f6ba3f9eb84dfe748e57a754c60078a2bf8bb6116aa20043b3eac9a
2825	0x0000000000000000000000000000000000000000	0xf5e6574f9f2c12d4a2e4fc1d6d5c4e76e10644a6	426.0252	21407473.971416884491463178	3919021	9	0xb41597fdc851523fcb19ec4db2ac81417d79c4483344956e54642974e66a85c0
2826	0x0000000000000000000000000000000000000000	0x76a7914d82fcb90ad82c3a5f1232b6ca5efda27c	478.68	21407952.651416884491463178	3919024	5	0x8a27b6b394f8f6f1993ff0ebe6c8407b50648680d6a754d98a4c82695a1e2ed9
2827	0x0000000000000000000000000000000000000000	0x95b422e81a4fe97d4c490ff57ad8ef3d1a5b5832	191.472	21408144.123416884491463178	3919047	55	0xfd0446f143a577772a74d13c6d5f1ebf90f615017ca3bca176dcdfd6ac30a1ce
2828	0x0000000000000000000000000000000000000000	0x2cc17a82d927a66eaf39acf5dbedce7f5d351f1f	95.736	21408239.859416884491463178	3919051	40	0x3dc1c1e8ad4ed90b6d76cdcacd1d9b98931bcfc01c53a244a611248a119445bd
2829	0x0000000000000000000000000000000000000000	0x2cc17a82d927a66eaf39acf5dbedce7f5d351f1f	335.076	21408574.935416884491463178	3919060	19	0xf1c9c720139255d458e24b6165cf239e5b80ccb2dec801912deb9b443de00c42
2830	0x0000000000000000000000000000000000000000	0x2714192fff07a9809b4bbe6524657477c81e511a	143.604	21408718.539416884491463178	3919118	1	0xfa566ad6fedb7a7bf4b8c49fa50e70e8e507f7d90e4797afd3f2657aec528fba
2831	0x0000000000000000000000000000000000000000	0xb0cbf149ba9e7d0efb63235a08768a7b63f0652f	1436.04	21410154.579416884491463178	3919121	17	0x53d370318251df83e63a00f1d159f3112010224db1da653e6a99896b6808245d
2832	0x0000000000000000000000000000000000000000	0x9f1c9e8609e355cb83dfb555ddf672043e627979	2823.73332	21412978.312736884491463178	3919121	35	0xdcb6bdcee39c5ad78712c6a0efabcd14dcc4da173fde6c4f1556ba7dd7071854
2833	0x0000000000000000000000000000000000000000	0x19022e6f3c328c3d17cc2fffd0724b8f91bfde98	47.868	21413026.180736884491463178	3919141	53	0x73cb9ce9b28571b16528cad537ce3e44143bfae1552bb8d90e341c66a059c217
2834	0x0000000000000000000000000000000000000000	0xa14d7a828a7a96fb9a81bafa28a72410d2ab1045	0.7387037628	21413026.919440647291463178	3919152	16	0x1af4649e84c66c16cb70b6421f078e44cf090c52ec8ee31d9143611954afd747
2835	0x0000000000000000000000000000000000000000	0x28d8c00ccff8dc2ef3e18614820e192a812f69f1	382.944	21413409.863440647291463178	3919162	2	0x35e3a8c80b66e9758f86566c60ff6a0b5dfc58dd5e50012b67c118cb6917a3a4
2836	0x0000000000000000000000000000000000000000	0xd0ede7a58852e4d8bb6eb5fcdec335e549248ec2	3.35076	21413413.214200647291463178	3919164	26	0x0844ee123af65fb690bd920909449c476af1af081d128332436eb94622d37382
2837	0x0000000000000000000000000000000000000000	0x3b3d486b31ccafb8d2e3147966bd7e5ed5825b8e	957.36	21414370.574200647291463178	3919225	0	0x501df6ea746e62cd99cb7c5bb46060b6ae7902914cf1b4241e107fa62b499f29
2838	0x0000000000000000000000000000000000000000	0x06a3ced7b3b7b9a43982f7385110d4027c82cb9a	1436.04	21415806.614200647291463178	3919247	23	0xd943fcfd9edb9d21edecc986423d640e1e83ae81fa1c03a8a9b5ccefc38f9a9e
2839	0x0000000000000000000000000000000000000000	0x41aa00ad3906f6036b473067ecf656179f03393b	239.34	21416045.954200647291463178	3919255	52	0x41792828a68e4d11d60a190c2af730fc3690d04fb3e5fb69bb50466e99973b16
2840	0x0000000000000000000000000000000000000000	0x3b3d486b31ccafb8d2e3147966bd7e5ed5825b8e	4.7868	21416050.741000647291463178	3919275	0	0x3b13d1ab86bea67d316b099124ccdc90b28c3e44dae7e36e930e7b4e0b0c1faf
2841	0x0000000000000000000000000000000000000000	0x06a3ced7b3b7b9a43982f7385110d4027c82cb9a	288.16536	21416338.906360647291463178	3919286	1	0x8f7c6ff48f04285997fb9953891541edd893b12cae75577e00fff98d80f751bc
2842	0x0000000000000000000000000000000000000000	0x3b3d486b31ccafb8d2e3147966bd7e5ed5825b8e	47.868	21416386.774360647291463178	3919289	1	0x916b45ceb4aa820cf75b43391962dbfbe77b8f13d1e4b17353004bfe1d1194bb
2843	0x0000000000000000000000000000000000000000	0xd54f87f2a9eedca8bd6b6ea0c2fe95456c768566	478.68	21416865.454360647291463178	3919295	35	0x95cd36cff517accdbc8fea054784aca94bfbb466ba2da25ab0dfe06abb5c1845
2844	0x0000000000000000000000000000000000000000	0xd1c347d57d646989de4554260b646617f14ea90f	9.5736	21416875.027960647291463178	3919304	87	0xf159296bb8480f2f7f2ca9dc309b40c1a981d0c9163a0265cfddc1f75f8294de
2845	0x0000000000000000000000000000000000000000	0x627b5e5df0946f35c6f2a66cd549932ea87e0c23	478.68	21417353.707960647291463178	3919311	118	0x8771aebfd615ee1965b39f8b63311c7acab6d4310765e1669a4b486e8ad28c08
2846	0x0000000000000000000000000000000000000000	0x42e21967f088cea324434227c8a1f4e3bfafa3e3	540.9084	21417894.616360647291463178	3919338	55	0xbd34baf3d4a51fc6dcbd378882c3a9d1c2537b6ad664e98991d5d7ad468cc631
2847	0x0000000000000000000000000000000000000000	0x3ba0f95f9211af05b2da56e5ad5f848ecfea6b6f	1723.248	21419617.864360647291463178	3919340	84	0xf59d3b72f3700686c2e7d64c1c793ee8d1428cfff9e74dc38134dcd2a923b154
2848	0x0000000000000000000000000000000000000000	0x22c4689cf7b9eb2475ba6792b4297bd8802565d7	47.868	21419665.732360647291463178	3919353	131	0xefdcfbf2747b3f376f45ca3e0734a73dce3343c391ed7aa961b115281e4bdf6a
2849	0x0000000000000000000000000000000000000000	0x19022e6f3c328c3d17cc2fffd0724b8f91bfde98	95.736	21419761.468360647291463178	3919386	43	0x2396d5cc926aa1632b5a0d766a39e4a5a2da1b3376e4c079a0e8c2057ddf0d07
2850	0x0000000000000000000000000000000000000000	0x22c4689cf7b9eb2475ba6792b4297bd8802565d7	1469.5476	21421231.015960647291463178	3919398	23	0xc56f92724e0fad5dc9abcd36bd65b73fdd3674ea52d6388e1b220918dc7e9029
2851	0x0000000000000000000000000000000000000000	0x52ff6c2e83624c1ec23cf3e444023d089ace1e42	119.67	21421350.685960647291463178	3919416	24	0xa82f991a92e9ddfb6d3c6c2f040f9b019e20d40d4f4a7a84179806d041b4ef3c
2852	0x0000000000000000000000000000000000000000	0xe47ce943570309d9397093c0061e21b2e66ffe68	478.68	21421829.365960647291463178	3919429	51	0xe5cfe4adb75acff4310a619d3cadfc942c6433456a4525ef3764b88747df0b12
2853	0x0000000000000000000000000000000000000000	0x4168814716e4ed77f1650e4afc729b2b013149c4	3350.76	21425180.125960647291463178	3919432	29	0x4db983fa6bdf35559dd637b26538275b3fafec22a93fee1382a00d01167c7c87
2854	0x0000000000000000000000000000000000000000	0xc0310890595b01d6d05595b12a82c70191cde8be	143.604	21425323.729960647291463178	3919437	59	0x3542adadc8b70400bc8ef0acd2f3ef01a508acc8f178d80188ff79e19c8fbbe0
2855	0x0000000000000000000000000000000000000000	0x70b1a17c49af5ecc2b4c8974e343179e6a8ffa7b	311.142	21425634.871960647291463178	3919565	8	0xf4d917724ad11e4e6c740fc2bfcaaa516de18b56125d018fcf0842291c90c10b
2856	0x0000000000000000000000000000000000000000	0x8d29504745e51803828df986e72a3fd55726b21c	239.34	21425874.211960647291463178	3919569	6	0xceefa442e6ba0941972411852dff37b953536b9c20068cc8385ea275d9cd3b13
2857	0x0000000000000000000000000000000000000000	0x85bad1dedbccdfafd231fe1c96b3a9bdd4e2e083	2393.4	21428267.611960647291463178	3919572	28	0x05a4eeb873f3bc58205b5ed2e2a0d01f5c9bd0ff6751fb89e8944427c2f6808a
2858	0x0000000000000000000000000000000000000000	0x179899d02c6c1c06a422969a3a7e4f5e266f7381	512.66628	21428780.278240647291463178	3919581	6	0x1150bf1b35408b105876dd6db6da47aa73a66ff951461b00002a7da1db09014e
2859	0x0000000000000000000000000000000000000000	0x7d02e99f7f9e19ac37d762c367f55e2fbcc4bbfd	478.68	21429258.958240647291463178	3919583	22	0xb6cc7b510167489e92e1d6e0ff7660a9771b1c22a3581e6d70a246f15aa8bda6
2860	0x0000000000000000000000000000000000000000	0xb574be92f6d2c9e65de8879b071fc1dd2161c488	239.34	21429498.298240647291463178	3919586	33	0xafeaf0f3231448d836d83564031ad9e92f9fcab32f28f8751897357ce9c64717
2861	0x0000000000000000000000000000000000000000	0xb66e4cd327c761fcbcac782909bde1518bcf55cd	957.36	21430455.658240647291463178	3919593	21	0x4f9ca1a81f94bd629dd544915a4d2c4ab736dd860d2918f4d494d8f59edafd8b
2862	0x0000000000000000000000000000000000000000	0xf842397b807d623aebb75c419cf318f490081dd4	191.472	21430647.130240647291463178	3919600	23	0x1720d656a1c1aef5eaec04ad24ecd46040cba344219cbe3ae6ec89a6efd84da3
2863	0x0000000000000000000000000000000000000000	0xfa1c732bf487bf3128a4658ca7ab8d303c036d19	7678.0272	21438325.157440647291463178	3919601	36	0x40918819ce4fe5ae5b0dbafdc11bf18ad8c0022721bebde097065026b5f27d93
2864	0x0000000000000000000000000000000000000000	0xf5e6574f9f2c12d4a2e4fc1d6d5c4e76e10644a6	2388.6132	21440713.770640647291463178	3919607	3	0x6beddb2da351b37b012d1d51f222740252cc93ce7ffa243ff8bc00dfa4d3ad79
2865	0x0000000000000000000000000000000000000000	0xeee342614b099fafa22f9a489f59d671af1fb32b	239.34	21440953.110640647291463178	3919611	76	0xd5264a0268f49bc020189f038f67804deddc759acdae657cb66d411055bcd34d
2866	0x0000000000000000000000000000000000000000	0x694311dc3d706062dda60fd8db933a2400423826	479.603957665989772437	21441432.714598313281235615	3919615	27	0xaaefdfd22e4fda393836e38575d9a39a7603e66baf5f1d1c93004b1ef9f4e5f3
2867	0x0000000000000000000000000000000000000000	0x85bad1dedbccdfafd231fe1c96b3a9bdd4e2e083	2393.4	21443826.114598313281235615	3919624	40	0x1e8eaa18d3af9f94602bdcd82044bb6b4bc9ba85620904ce113549baf3dbd35c
2868	0x0000000000000000000000000000000000000000	0x3be801b5f6ef8c1f87a83127100b9c2c9fd18b53	239.34	21444065.454598313281235615	3919624	46	0xcd115377d74264ee8ca3256d7b95848bf7a5793b489b447b6070d6841ad725bd
2869	0x0000000000000000000000000000000000000000	0x4eb12ba2b89863b29321dc0018d7c49f00272013	356.6166	21444422.071198313281235615	3919652	57	0x8662d61d06a2cbfc44aac5056da2ca07368d750640af87d8691850b775f95769
2870	0x0000000000000000000000000000000000000000	0x0082c88ded0e661da9d12d521d0ca0882739c11f	71.802	21444493.873198313281235615	3919656	29	0x7bb4bb999c58bf1287f6007ee3a98ecf6c90106bd928be500aa64356be48a4a2
2871	0x0000000000000000000000000000000000000000	0x59cb7782cde686f5d19313a513d6eb95bdae60a8	239.34	21444733.213198313281235615	3919672	36	0x2d3c23c572e32846019c994811d82b6f5462b0f453489f59cd8c8426eabc4aa9
2872	0x0000000000000000000000000000000000000000	0x0082c88ded0e661da9d12d521d0ca0882739c11f	71.802	21444805.015198313281235615	3919675	16	0x9238db5707cd33e6433499ed3022c04084458f09b51c54827281e6671e33c043
2873	0x0000000000000000000000000000000000000000	0x6980a0566e65fca06c7b71b97be583f29e12111b	1436.04	21446241.055198313281235615	3919682	29	0x032de2b32bef5c27ee656c8db00bd0a3748cb0a1b6185b39852cd4c291c57139
2874	0x0000000000000000000000000000000000000000	0xeee342614b099fafa22f9a489f59d671af1fb32b	957.36	21447198.415198313281235615	3919706	60	0x9964f5e091358bf1de9e533dc19b1a9521e7f06dd4df27ac2e559000c1189121
2875	0x0000000000000000000000000000000000000000	0xdb79b36ca1b0cc077261a2480622f6c455c88fa0	3350.76	21450549.175198313281235615	3919737	40	0x1eed9e5c03120fff73be1af060bcefff5076eb65bb424fab38b404bc29a63afa
2876	0x0000000000000000000000000000000000000000	0x15ed2358fb4e96607480ca027a3ad0b1b3d872ba	2393.4	21452942.575198313281235615	3919760	15	0x7bd71c1f23870bcd4c38dcded977fbac7b39e699bfb06ba08c90a4fe737fa0b5
2877	0x0000000000000000000000000000000000000000	0x447847779a459ccdf79710454ec0df5d36fdb135	119.67	21453062.245198313281235615	3919789	58	0x03fddd01d7fdf412a2a466f5870583979ecef4ac79e96b419d69363f98be18af
2878	0x0000000000000000000000000000000000000000	0xb574be92f6d2c9e65de8879b071fc1dd2161c488	229.7664	21453292.011598313281235615	3919813	13	0xd9f4cdb6333daccbbf7a032794bdc356a55883601be4917652e31d4e38e3a960
2879	0x0000000000000000000000000000000000000000	0x52ff6c2e83624c1ec23cf3e444023d089ace1e42	119.67	21453411.681598313281235615	3919823	82	0x98900169c3d67a7e2479d7ebcac3717b5fc3195b7dfeb5f79c3bf6607c06f907
2880	0x0000000000000000000000000000000000000000	0x61f73211d045900b61089279c570211a45bcdf52	34.94364	21453446.625238313281235615	3919848	53	0x2538f6636863c40d7cb14a1370d32b8005463c1643f981d1db06dcca2da22269
2881	0x0000000000000000000000000000000000000000	0xdfeef7c96cbe59d76fe97e629c13f53c93f46b1a	95.736	21453542.361238313281235615	3919959	70	0xd4033142fa65b36b13a4d136c165b2d0714035104bd44c52108300a703a41d80
2882	0x0000000000000000000000000000000000000000	0x25379c46f374c1eb3cc0646da8b23fdaf7362a3c	478.68	21454021.041238313281235615	3919983	14	0x9336a19583195cbed1b56f72f46e6d5cc55029799503b84f396788c106c861ed
2883	0x0000000000000000000000000000000000000000	0xd9b368bbc477cfada4c4ae83b0f4c356c9a8bc93	119.67	21454140.711238313281235615	3920016	22	0x919df0f201bcd145ee219fdbd04ee45920def6544dc0c903b98fcc4bee346c00
2884	0x0000000000000000000000000000000000000000	0x579a9938f07065653bf8c2af77272afe825974ca	44.469372	21454185.180610313281235615	3920046	39	0xf73283cae1b7677599e6522c5248714291c42eb604408500f8b630cb0324f0de
2885	0x0000000000000000000000000000000000000000	0x660e067602dc965f10928b933f21ba6dcb2ece9c	2393.4	21456578.580610313281235615	3920048	66	0x4d35a14f0f73b873947d4c1c70c27e89d419b4f10636904a147f62aca0e82599
2886	0x0000000000000000000000000000000000000000	0x526f43fbf21cff45400272edd0b39604e4c9573f	1436.04	21458014.620610313281235615	3920051	0	0x0db57a45f2d06bb5762dd404592c49c9e48f2f52db6ee90e210fd3244743453c
2887	0x0000000000000000000000000000000000000000	0x1fa25add14b107c6afba20efd57ab61b905aaeff	1914.72	21459929.340610313281235615	3920089	33	0x2666f73a362db99a73ebb1f84ed439d1daeb230a216f8394831cbf55bcff6376
2888	0x0000000000000000000000000000000000000000	0x24409cdbfbffef1c5dd02a71aec9f5b8203020db	23934	21483863.340610313281235615	3920121	3	0x26901fa904bf8105dfe9d98e6064f7fba01aff1a52d9c2fcdad3e2f4f4021f82
2889	0x0000000000000000000000000000000000000000	0xd9b368bbc477cfada4c4ae83b0f4c356c9a8bc93	239.34	21484102.680610313281235615	3920154	123	0x4be3e5bfd29c8a82ce3efb99d28201b292eaec74cdd9985e61351d8bfdf09002
2890	0x0000000000000000000000000000000000000000	0x6afc2d3e5bda7402f3e6279692709be8f100006d	156.5854617372	21484259.266072050481235615	3920156	19	0xaf22511d1690320d3fd74b73c197e400e6d81f1105df3ab8069a49cd4d417bf0
2891	0x0000000000000000000000000000000000000000	0x3a4c9427d04c288691281a989aced7ad7c1ca239	19.1472	21484278.413272050481235615	3920189	6	0xf3dc1399470504ea7ec80d91172a620eab0ddb205b7fa7e1e361206d041d8145
2892	0x0000000000000000000000000000000000000000	0x06e08a7e417f7167264921a33ad3cf4e4dd34f09	957.36	21485235.773272050481235615	3920193	3	0xbd82683308556585556e9b26aa324d87edd12fdf79d023e057b1f885e5ca3b45
2893	0x0000000000000000000000000000000000000000	0x00aa6538c4a86c40ad3d80055d2c385c5fff8e1e	1196.7	21486432.473272050481235615	3920195	8	0x48ecb6bf2b43c7f97e22b0c2b25e30c31370cbe4a1d0f98086b335cf8c5e0516
2894	0x0000000000000000000000000000000000000000	0xb90bf1c39a56602293da0ac92c1fd7606cb156e1	4782.0132	21491214.486472050481235615	3920209	22	0x0244a52d19cdb7ecc2258cc3bbcaf2fc5f0bc453db0f7906089876a2483260c2
2895	0x0000000000000000000000000000000000000000	0xc845cbfb279d59b28cf61bcc830f8f4b2be4c3b1	191.472	21491405.958472050481235615	3920243	1	0x8e68684b6fd54015c3b518f5fe7974db6f502355e08a65cf0895d6141a5316e9
2896	0x0000000000000000000000000000000000000000	0x236b88a72a66edd57d305fade53eb221c6347179	718.02	21492123.978472050481235615	3920272	73	0x51252e58d3a04ca6a2ebb55f0d8d896e62b8e2080c2ab3e30b25ff81f870c8b2
2897	0x0000000000000000000000000000000000000000	0x1e0cc3a5526d0990c3b10575af88a146bbb0a8d2	5265.48	21497389.458472050481235615	3920277	6	0xec793f85e08d9af681548f1f2b24d0b848aafb0172af41230e1ff9baec066fc9
2898	0x0000000000000000000000000000000000000000	0xb0efa3d4e663c5489366e2291a0b1c936c36a175	66536.52	21563925.978472050481235615	3920279	190	0x3eb17d983f2b9febd153e30ddb2e66e954f0f34ec54c88155c25c7d6df6bf053
2899	0x0000000000000000000000000000000000000000	0x925efd60f1649cead34d34ae1fcdcc527d1fef12	143.604	21564069.582472050481235615	3920284	69	0xc1c68cf01898df2e3b435d454536dadc76b010e4f7eea866fca20426a71a8722
2900	0x0000000000000000000000000000000000000000	0xd5b02cf992f6748c894a46476ef8825134d2a060	478.68	21564548.262472050481235615	3920285	19	0x8fc3af3ba4fa24d8908156a6d81988fcdb8365b7415a1791940a3f6c8348fc43
2901	0x0000000000000000000000000000000000000000	0x3a4c9427d04c288691281a989aced7ad7c1ca239	191.472	21564739.734472050481235615	3920293	200	0x28fed1717183c5e2a7e35e5852a5b8a53322cead939fc453054faccb2b175701
2902	0x0000000000000000000000000000000000000000	0x925efd60f1649cead34d34ae1fcdcc527d1fef12	95.736	21564835.470472050481235615	3920304	15	0xdc1e4f7692dc44118c5d4a03b405205c59ae100dee750067f82ab5a8b2f6d32b
2903	0x0000000000000000000000000000000000000000	0xfd43bb5e51cd6558e6a3142a8b6dffdb909f4e30	478.68	21565314.150472050481235615	3920304	20	0xe352351c1012db3747bb43a1005b8a0f7b325ab9da1a6a4b9e1b3d5acc462f04
2904	0x0000000000000000000000000000000000000000	0x0a1867f048b57bf970b31fce9f4053fa9c48c47f	14360.4	21579674.550472050481235615	3920324	2	0x62cceb44545e2cd654a9c38ba0cfad7d135371e0d400cb29ea65a562d262a8fb
2905	0x0000000000000000000000000000000000000000	0x6d5b970cf71dfc5bab751a5867b3db263a15226c	105.3096	21579779.860072050481235615	3920332	40	0x6ec18e9fc32b74b541bd26f1f3e0b2307c12c5c969204815aafb360157e489b3
2906	0x0000000000000000000000000000000000000000	0x1e6c6cd7614f8189fcc46d3bcc8281f6be236c32	143.604	21579923.464072050481235615	3920342	21	0xbae8eeba87d44a6d1df0187081f34cac309bf7e653f08548caeee1d03827d47c
2907	0x0000000000000000000000000000000000000000	0x1e6c6cd7614f8189fcc46d3bcc8281f6be236c32	812.79864	21580736.262712050481235615	3920360	13	0x5716f7b885a104b955e53b36b962172aa5bd1cbb2587193fb9b4c271c11866e7
2908	0x0000000000000000000000000000000000000000	0x0156705ee9167db08a716b481f87b9c34fe44a6e	47.868	21580784.130712050481235615	3920378	11	0x9a3847ff2a36e6c13fffd164484d6ec560c30c9ecb7705cf607738026aa55e82
2909	0x0000000000000000000000000000000000000000	0x654ae9a08e15cea8d7d8bbce09f06ccc1cd8024a	2393.4	21583177.530712050481235615	3920448	22	0x7bcac45e8fba9fb5d89c7f7b667bf64b680224f10880ef57724bd9181bbd2e6d
2910	0x0000000000000000000000000000000000000000	0x23bd56f5f8f9dec5a071cbf9bd3908dbe31bacff	143.604	21583321.134712050481235615	3920458	60	0xebbd83b837f5be2277ee0f7078fec9daa45a7416b865de791a0653ab4d513f48
2911	0x0000000000000000000000000000000000000000	0xee4d4371759753d89c9e2f5ea63296cce6d1ac56	1052.16472806	21584373.299440110481235615	3920466	6	0xa885073e6f5f046e545435453a65dfef25d8082b8c0dd4a7b3ae8896a2c222b7
2912	0x0000000000000000000000000000000000000000	0x00a4f5ee82bc0606e0b5e76d4671daeca9cbd92d	478.68	21584851.979440110481235615	3920474	55	0xddec0606582b8d5cbc6f623c436c418e133e348a4ee92de972041fafdb62e8ad
2913	0x0000000000000000000000000000000000000000	0x644e6678fda88c39202eb7ce7120f6a549cede1d	4786.8	21589638.779440110481235615	3920488	26	0x24b41657fa2f91a4d59d892a890ff901878547666f83929cfe2172c4f9c39353
2914	0x0000000000000000000000000000000000000000	0x17e43a54fa131ef8cf31ab8b15c219002765ef0e	239.34	21589878.119440110481235615	3920492	1	0x9260f7587463f4b81c4171af18b81b3ba7c688e380e0619af8a5ea496388ff05
2915	0x0000000000000000000000000000000000000000	0xd5150323040403db652b8d5556afd62749cfc961	1196.7	21591074.819440110481235615	3920524	6	0x5ad2eb6179ed8a3efd107db7af49dc28347c038aaa069a0059d6ae4c550adbd4
2916	0x0000000000000000000000000000000000000000	0x7478cce9537ef0ff0dd2a50b17a447a2cf56def3	47.868	21591122.687440110481235615	3920524	7	0x6b55dee16ddd7ce21a0f1af4c63cded21b5c28e05e51b99b760509e8c99c67ba
2917	0x0000000000000000000000000000000000000000	0x0190bce30adce7bf505e5a64a86a69c09c402e79	4020.912	21595143.599440110481235615	3920647	0	0x9cd709d20c21cc44921c5cd1e1a4d42cec19e9380996c7f9e9f99fbe19f5ecb9
2918	0x0000000000000000000000000000000000000000	0xf771ab8a7aa60e0b229b2f551cc44eef96789174	191.472	21595335.071440110481235615	3920665	29	0x24cb67b20898c0ac5b42f3a8508333e987241781b9410aef2684f1b32b746a5e
2919	0x0000000000000000000000000000000000000000	0x5f467025429ee4a67291cd916e886ddb776786f8	59.835	21595394.906440110481235615	3920674	75	0xc3133043f20354af1b6bc5a64b1d36996d7562c0abc50076c7695248aa74de73
2920	0x0000000000000000000000000000000000000000	0xbe296fc850a66bf7da2488b887a34b9f309df52f	478.68	21595873.586440110481235615	3920737	11	0xce389a881a198f89802640d566062177fbf09fe362c902f7dee2ef7827e483c7
2921	0x0000000000000000000000000000000000000000	0xe9c4554a5bc53f2b207d56ff938b2a0bd0c8b013	47.868	21595921.454440110481235615	3920737	48	0xa7c7d93abde6d0e86166224422305755e9e96fdade787501ff329772b01b3f89
2922	0x0000000000000000000000000000000000000000	0x91d0afea13720fc16a167519517ddfa97fe7dc01	191.472	21596112.926440110481235615	3920772	29	0x640d52ecd9b87f74a3ffdffb51f51044a6e20ab9bab9a5b9f4bf1f43f22e444e
2923	0x0000000000000000000000000000000000000000	0xc306de8ead457d080896a8730b3fff7d0c5ec373	98.6032932	21596211.529733310481235615	3920772	35	0x54a533ac0c8fd83c1d3a0f40f6da90ab0decfee5e782887009209e4bc04a04e0
2924	0x0000000000000000000000000000000000000000	0x91d0afea13720fc16a167519517ddfa97fe7dc01	3350.76	21599562.289733310481235615	3920789	51	0xeaecb6b218f0c1104357ffbec2053c1dff1ab3be799f01fbb6fbf2a414a1dfad
2925	0x0000000000000000000000000000000000000000	0x22a48f0e4c041f9acaf9886a51244889c3da9912	478.68	21600040.969733310481235615	3920806	32	0x480330658638280c6f5112e427bfa6496a5aa9ed4fd30e7c7e1e0bb5a10bfc85
2926	0x0000000000000000000000000000000000000000	0x4456854c7b9531ba763d28d35c8f93a6b19bd70a	478.68	21600519.649733310481235615	3920806	50	0x458624c3dd7026b511372fb411942beca72334acda07783986651d875a1647ce
2927	0x0000000000000000000000000000000000000000	0x366f7effc26222dfe9fd3e4a9ae35e1fc6e7678c	57441.6	21657961.249733310481235615	3920836	15	0x6f55c6cf30b7a0ca97e8261d6685d1f2b8cb867ed637eff73a8d34abe6633ba1
2928	0x0000000000000000000000000000000000000000	0x6db8b70b3fcc1ca40636d8fee4b8186f900b54e8	957.36	21658918.609733310481235615	3920849	6	0x760ebce7d120db247e3cf630694e807d57367baea0d5ddebf903d996cf026af9
2929	0x0000000000000000000000000000000000000000	0xd257bf596b6765042425449f1c70137b44e06cc5	2393.4	21661312.009733310481235615	3920926	24	0x6a39432527ce05a98aedb632f4750a907f9decbcf0953d05e1a25b6ae22d3cfd
2930	0x0000000000000000000000000000000000000000	0x36c7a54c65d9668c0703715763273bc2e6f8f280	3494.364	21664806.373733310481235615	3920936	31	0xf0f9f1e52ad97eb601fc6acced16df42520a1b9038c341b10fca2c9dd4c64efc
2931	0x0000000000000000000000000000000000000000	0xa2c061983d75d471c8be05f9a6f7b574c34955f2	2441.268	21667247.641733310481235615	3920943	12	0x5192c7c458567e89a7aef367912f2ab061dfad5ba2442185305cf43366d513db
2932	0x0000000000000000000000000000000000000000	0xdcc34f1450e3c6ce709a90ceae18b91ba2a3cab1	4786.8	21672034.441733310481235615	3920953	15	0x4cff10a9644317de77a883907f2581701c6ca6fbd7e0f3f7bb319d98eaf2d096
2933	0x0000000000000000000000000000000000000000	0xda13916fc279e239dfb144094af35f3a56d42f08	478.68	21672513.121733310481235615	3920994	26	0x373a0582de31463071b0472101e02f8b24f24384d67dc9ca057d9288efcf8aa6
2934	0x0000000000000000000000000000000000000000	0x401354a297952fa972ad383ca07a0a2811d74a71	1436.04	21673949.161733310481235615	3921010	9	0x5532fc28edf749b15c1f5a12b7b01b7bc133a15efcd59d428d330de22e2170a3
2935	0x0000000000000000000000000000000000000000	0x3b365b2feecb489b2677625f2eef9e1cd8545a99	2393.4	21676342.561733310481235615	3921016	39	0xbe676a28942f587d897a46e4a6b84b622039bfb5158a3feef3814fbc0d5b6d51
2936	0x0000000000000000000000000000000000000000	0xb8e5691bfe1f77b7a2032c6f156d6d93cfc17c16	4786.8	21681129.361733310481235615	3921028	1	0x0d9b3842ff16db303e064c68589a8c58b9b5fab0ca0398e57322e5b025f1fe4b
2937	0x0000000000000000000000000000000000000000	0xa68797bd85e3a54613aa57da877a871d644c20af	252.74304	21681382.104773310481235615	3921030	10	0xaa4c8d19e47d0e1591fe3e79d19827e54ac6a036bfb19442f8b0fb6311c84994
2938	0x0000000000000000000000000000000000000000	0x16d4245339ad98bb67b546b9725b083bab6fdc78	1431.2532	21682813.357973310481235615	3921036	66	0x6ffa9f0138f023f96b3535b0512532be47828163aae3ecb4ebf78a8e61df55ef
2939	0x0000000000000000000000000000000000000000	0x1bf060fd82e8a94efc251fd011c22704aa7b9cfb	1436.04	21684249.397973310481235615	3921036	68	0x77d4646e7f77c132317aab8dfe707cea8e3f5fbed15414e996e4e22c86f1a82b
2940	0x0000000000000000000000000000000000000000	0x9c7403fca134365f0468c8391d542474c4a3ad4c	143.604	21684393.001973310481235615	3921045	48	0xe62bd74988adad8badccb21bd5d37b9bf03c207f035afea34090b499bd1c30ea
2941	0x0000000000000000000000000000000000000000	0xf3de7b7f6f67fb193608fb8338d3275f79ee1af0	1105.7508	21685498.752773310481235615	3921086	56	0x15f380471c4c03eac1c2f7ee5ea253c1d70fe5cdc0560bb33344c121a5d5278f
2942	0x0000000000000000000000000000000000000000	0xeaadb8e3430499393cd5049ae01efe8ac7bc93f6	56.0386559352	21685554.791429245681235615	3921095	1	0x398402ebc8ca52562ca5a63ab16b0166a2e7a1dee4b9a9d9426993c4105b1f8f
2943	0x0000000000000000000000000000000000000000	0xf1ede2d9f6fabc14c7ec86051fe61637c10e4f24	110.0964	21685664.887829245681235615	3921148	45	0x1a78ede92fe8f76b5f38907eb947a60ca0e84eb28a059aaddc46970070f14fee
2944	0x0000000000000000000000000000000000000000	0xfeed9cc3593a6dd52a20dd3c78400609ea41638e	478.68	21686143.567829245681235615	3921194	14	0x41ac76e5b7e36012fbc5b433d1ae67401089d3fee217648c839205ee7c5c7075
2945	0x0000000000000000000000000000000000000000	0x0a9e7468e21187f72f2b1cf89052456d19701e76	4786.8	21690930.367829245681235615	3921217	0	0xcd4eee32f1d4f9fdfe060e2c7add9ba492255d7628097c55f68ace27aec9abd5
2946	0x0000000000000000000000000000000000000000	0x99f49c3ab83d5fce83c40f7d6e7101d3d8192c3e	914.2788	21691844.646629245681235615	3921217	31	0xfd2317160c0b71d10eee1dfa8ed2f559d18e59b5afe567fb4c42fa087bbbae32
2947	0x0000000000000000000000000000000000000000	0x4fdea21c24b775ab8288708ee6ba31299d829602	665.3652	21692510.011829245681235615	3921225	37	0x4ebc9a6e314eab5de61ce60889d9b5f39deabf9f72daf07261e5777cdf772f40
2948	0x0000000000000000000000000000000000000000	0x0363e236269065d43ca8c22c32c98bf784168a41	2393.4	21694903.411829245681235615	3921233	0	0x40f5179e6b1bce84f97e89e98f3de67471853161a2d95f1241816b69faf25dae
2949	0x0000000000000000000000000000000000000000	0xce949467a02c4eb993a2205a2b979db1dc0dde70	1436.04	21696339.451829245681235615	3921238	5	0x09f335f129702ffbed8400f80a8e23dc07ad191d971eaeed059aa56541d79cd4
2950	0x0000000000000000000000000000000000000000	0xce949467a02c4eb993a2205a2b979db1dc0dde70	3350.76	21699690.211829245681235615	3921263	10	0x03be078156175fd1565f1e41c9c7a56ea85725e507af8f16e1826c6448a236eb
2951	0x0000000000000000000000000000000000000000	0xc554db5f7a3f02d440302dd282f81cc2a470acd8	930.07524	21700620.287069245681235615	3921266	106	0xcc0f1a21cfbc0e2a769c0b21fec6a3d4ae4698253283e05c678237a17fdb1465
2952	0x0000000000000000000000000000000000000000	0x446df66e6c31e5afefca22d4115ce115e6de54bd	191.472	21700811.759069245681235615	3921269	2	0x496162a380f732d7507442c0b7e49b47526d0ce58606ac1871fae503fa5c3e94
2953	0x0000000000000000000000000000000000000000	0x1e51ead07622a56069d8a5effcb4a4daed09e2be	14360.4	21715172.159069245681235615	3921275	78	0xe5336f519e721695f30c642f716c52380038cd66efd4295aaa9df45d07e0c479
2954	0x0000000000000000000000000000000000000000	0x27a5be7e0022c7068be35acdde5df3e5df5fd16d	2393.4	21717565.559069245681235615	3921278	10	0x9deda4e720aecbcf1ebe9db273516164b02cbbf3cf82a2e48cd9faaf56f4e54a
2955	0x0000000000000000000000000000000000000000	0x35a05a262e66db21feb37ddcef73b625c801512c	478.68	21718044.239069245681235615	3921285	26	0x1ac43bd9cd4d0a0e771f49a83d3e7c8bb93698386056c38741fdb7a33c61920b
2956	0x0000000000000000000000000000000000000000	0xe02c74aa415aa6742798d7fc656a21b88aa4fa47	47.868	21718092.107069245681235615	3921297	8	0x25c8c1bc28126a36c39b312dedc34cdfca582e0dfd980cdff5bec1ed843515b1
2957	0x0000000000000000000000000000000000000000	0xcdcb251430950b037a666a6cdf3cc580e29b4f69	473.366652	21718565.473721245681235615	3921311	29	0x352bec92169b95629df83a8dc885c59976991a98b78717b49e5e755a1fc1642a
2958	0x0000000000000000000000000000000000000000	0xb8e5691bfe1f77b7a2032c6f156d6d93cfc17c16	2393.4	21720958.873721245681235615	3921330	16	0x47c9326fc2a6d48dd4380136e739b1c8fe1fc2e74c57d83ffdfae38aef0861d6
2959	0x0000000000000000000000000000000000000000	0xb33d80c9d7b1e274ddc347d9690193c8b77bf2a8	274.471916811	21721233.345638056681235615	3921334	65	0xbccbba1e98225a728c70f10eb37f0c16b99c07361f2dc1dcbccc032ee07dc46c
2960	0x0000000000000000000000000000000000000000	0x83ed90e6758a3845b1f113506156d93d752b45c0	957.36	21722190.705638056681235615	3921339	40	0xa24dada4c4f8076795189f7d76e014ac45ee9bf81e5491a2f34d0c61ac212b07
2961	0x0000000000000000000000000000000000000000	0x6d4d79bf58e29bce63f9a45982c18489bad61450	1914.72	21724105.425638056681235615	3921385	51	0x335dfe11d0b6ab75b4464bef53f147531ff5187326d69246dcba6d30d60617cd
2962	0x0000000000000000000000000000000000000000	0x8f60895fbebbb5017fcbff3cdda397292bf25ba6	47.868	21724153.293638056681235615	3921388	5	0x7b1faaa600aad63b8020d35bcb91738f331d876b59ab0ba6dddf9c5db0a2d5ce
2963	0x0000000000000000000000000000000000000000	0x9b0e2c7f4167d260008510a25008d9c96a0c1923	508.35816	21724661.651798056681235615	3921390	41	0x1ae68e2111301aec8b06c7ef8af558a24feb6cf0453eca1bf54efe02a0ce38b0
2964	0x0000000000000000000000000000000000000000	0x8f60895fbebbb5017fcbff3cdda397292bf25ba6	909.492	21725571.143798056681235615	3921392	2	0xf0ece2cc08329a9945712127a639ea76cb6e9cde54333f9120b5489a59901842
2965	0x0000000000000000000000000000000000000000	0xa7c3c2d13bd4420484d94fddc6278e89b699e352	467.5976389344	21726038.741436991081235615	3921399	13	0x34a98a61e57f079cb0e1cabf3de1c08074773a8b5e967770d3b2c8c9eeef9d05
2966	0x0000000000000000000000000000000000000000	0x924673874e1b8ac94d089130ab8d0a02e948471e	1436.04	21727474.781436991081235615	3921415	4	0x3253b2cc22f594f8990ce9c5bb3f1bfebd7aea47b475674cf709c7a4429c27c6
2967	0x0000000000000000000000000000000000000000	0x68f3cd7a6f0509a2f219f3a01ce8f45ecd1850ab	478.68	21727953.461436991081235615	3921415	6	0xefa34bc17689e42cf504f04e31905591c86d2fdf04afc02f3daff0932803dde1
2968	0x0000000000000000000000000000000000000000	0xe3d77921eb7176b9e6001fcd85f96d30a30a0c15	947.7864	21728901.247836991081235615	3921433	51	0xd3e70a2e975d0e195c02187d639e3326adebac0513d5a3720ea7d1aebe2bd883
2969	0x0000000000000000000000000000000000000000	0x1df5044fb7a167c0a4573f1418a806632c5903d7	478.68	21729379.927836991081235615	3921453	29	0x8ce19787c196fe4531670a3c3b6540a3f8fb74dfb5c90eb3e2a57b604b31ba78
2970	0x0000000000000000000000000000000000000000	0x9fb048494bdbea9e6e13cb553ff39257ccb1e715	478.68	21729858.607836991081235615	3921459	19	0xfde6e5d55ef9d9c55ba14e596b65a8e6c134f5e28aa95113e769786e74d102a4
2971	0x0000000000000000000000000000000000000000	0x5a9fe3efec3050c2272efbe2ce729c50eb5f6d5c	239.34	21730097.947836991081235615	3921464	8	0x74bb85395dea10cd7bac914f9e7752061efdde8c639b450831c3429e35250759
2972	0x0000000000000000000000000000000000000000	0xc59967029662c246075625e7445dc7930c93a2de	335.076	21730433.023836991081235615	3921469	10	0x039efa062bedf1d248558c607a6dfa9a2d9561ed319b9cead8bb1d070ae1d07e
2973	0x0000000000000000000000000000000000000000	0x949e29ada34653f1a6c3cb897a01909ca7d15759	143.604	21730576.627836991081235615	3921469	14	0x670fc0368c727ebc6553e47cbf75abcb9bf37588a735ec941332c1a073588118
2974	0x0000000000000000000000000000000000000000	0xdf28dbd79109f32215118eadac074ea3902f553b	81.3756	21730658.003436991081235615	3921507	43	0xe5abcd8a6868cd150b99531bcf69e1b790752c7c9234886f16d5b26036a239b4
2975	0x0000000000000000000000000000000000000000	0xbb2f4f3a7982eff031c561e7d10b9ff0ce4953bb	1005.228	21731663.231436991081235615	3921510	4	0x754a8e2fbaa4319f37d6eca1a994f69fd5b370d503a50f6b8da3f7602db9d622
2976	0x0000000000000000000000000000000000000000	0x3d5e249687791c1c3c8377a99d5cbdfbdc62516f	1436.04	21733099.271436991081235615	3921516	3	0x6e06661f1846f831654d912db3e154d3bbc81ea5a88fb44c946c4ad2fcef6c28
2977	0x0000000000000000000000000000000000000000	0x1df5044fb7a167c0a4573f1418a806632c5903d7	478.68	21733577.951436991081235615	3921523	36	0xe9d20a683757aa94397ef7df74f7d6d96741091ea77ac223fe7ae730c8ba93b1
2978	0x0000000000000000000000000000000000000000	0xf1ede2d9f6fabc14c7ec86051fe61637c10e4f24	38.2944	21733616.245836991081235615	3921537	43	0x6c19e20e45e06a17e5ff13b224298708c0da6aaf28a908925b1f17691c8ffb73
2979	0x0000000000000000000000000000000000000000	0x852b1bc8613a32aee1ce143032529b824fcb1e74	478.68	21734094.925836991081235615	3921552	50	0x93e65a8b947ab76a4cc4b15bb3f3b56ba5baf620930bf0a4547003228effbb41
2980	0x0000000000000000000000000000000000000000	0x7d675f49526a9e017d0ad6bc6821297b7074eb8f	574.416	21734669.341836991081235615	3921553	0	0xddb95d541848c779bbc5e7a7d2a803f07c7af27646ed7b7a9c35649caf2c25a8
2981	0x0000000000000000000000000000000000000000	0x7d675f49526a9e017d0ad6bc6821297b7074eb8f	47.868	21734717.209836991081235615	3921562	3	0xebd787a2382cb012e5dcde2b59f6db1d6ededf6fa162bd33b1bb25f83be37804
2982	0x0000000000000000000000000000000000000000	0x04da469d237e85ec55a4085874e1737fb53548fd	1436.04	21736153.249836991081235615	3921565	61	0x6663cde2f73afb285fdaccc38aa036d77c9ec8299e990f0ceeaa544e898acc33
2983	0x0000000000000000000000000000000000000000	0x1df5044fb7a167c0a4573f1418a806632c5903d7	17.23248	21736170.482316991081235615	3921579	0	0xabe748c6ea1d07758ab10de2045a3cbeb0dea136d5e208a0fb0d379a897df28a
2984	0x0000000000000000000000000000000000000000	0xc3dec1de53b09d042250aab9e1fc16fea7b36c04	4355.988	21740526.470316991081235615	3921579	26	0xa37474a09be260d5c6713a9ef4000dd9fb23c842df91f4a89bfcc91824dae8bd
2985	0x0000000000000000000000000000000000000000	0xb178bfe776bb2bcfb4016ecacbad41bc6dd037a8	4978.272	21745504.742316991081235615	3921614	15	0x36469803001132fba2d645b953b57a1abba5bd2eed151dc72b240613a98ed07f
2986	0x0000000000000000000000000000000000000000	0x0becccfae71decfe3a115b970c38e233daab995b	478.68	21745983.422316991081235615	3921639	1	0x5d0f3a843fb9a1c25315904e128fde25cb6819fca547279c2bf971e0f5acb873
2987	0x0000000000000000000000000000000000000000	0x9859f916c7b46aeae52bee615f93f2f4641bbe6e	2106.192	21748089.614316991081235615	3921651	10	0xc88c0378812ebd073b925f143659c4acc6f508cae6a8241d49e00028d47abf27
2988	0x0000000000000000000000000000000000000000	0xa972065fb75d9879f5d3ead700e412f7b56f8ed8	4308.12	21752397.734316991081235615	3921710	13	0x80090bfb90594b386a25c80016ac85ced7bbc0251841e9236dbe5ef8e9f62d1e
2989	0x0000000000000000000000000000000000000000	0xaecc8d74efa9b0ee79332ea2d6efd06a07ee4181	2130.126	21754527.860316991081235615	3921730	20	0x4b060960a7c25bffde214859cde9c44b353dbe7ff7c0ffb39a6624174b77972c
2990	0x0000000000000000000000000000000000000000	0xa972065fb75d9879f5d3ead700e412f7b56f8ed8	513.325518096	21755041.185835087081235615	3921741	7	0x384d47e0239859ad4f423f1c27b9d7e9552c4b3207b2795450c4f460f7e11427
2991	0x0000000000000000000000000000000000000000	0x481e3014b21701378f40739e517a02407588064c	1914.72	21756955.905835087081235615	3921763	5	0xd9040fd8aa69045a3f7da326b8864419b46360e84e45bd5afbea4ee65cade347
2992	0x0000000000000000000000000000000000000000	0x71208955a4e17dbd040928cbd46aeb0ae4a7da86	191.472	21757147.377835087081235615	3921769	3	0x5fbcbeab29814e0c4ffaf17ddf506861b9080f8ac1c9d57f15007361c4e2b849
2993	0x0000000000000000000000000000000000000000	0x413a7570f9a322b1d91dacd83af9b9eca50c02aa	952.5732	21758099.951035087081235615	3921776	15	0xe8ececf3a0d1915637c972e7acc2fe23d3037d3d560505e4391186c7d10e5499
2994	0x0000000000000000000000000000000000000000	0x7a46a73a518e44d3d0418276e9cff7bc67fd1300	492.872862	21758592.823897087081235615	3921820	31	0xcc3b29b8d653bde45231469d12d073c6098d885e885a4a0212f40bb7acda36bf
2995	0x0000000000000000000000000000000000000000	0x825206aab64be0bb1a824fa5a00541cb73b39cb9	454.746	21759047.569897087081235615	3921820	40	0x0df4f8609b048307e8f964ead4171fe068eb18a40218eb3e7f03f80d3b8505d0
2996	0x0000000000000000000000000000000000000000	0x14128502fd9848090812dbef5857e8d6034158ce	1914.72	21760962.289897087081235615	3921844	1	0x0d006cf3534d435af8d5ef27cb80ea928c518cee09f0f29bcb917973dba46c06
2997	0x0000000000000000000000000000000000000000	0x47045d1ee924ad6ff890ce8b52d6c1f08ad42235	23.934	21760986.223897087081235615	3921857	26	0xf2e3757dea0812becc6901bb674a1f1db90efb2fb24663a51d4d0f3ae1be137f
2998	0x0000000000000000000000000000000000000000	0x001016042aac422306b3c974cd5f70e627d82072	4786.8	21765773.023897087081235615	3921869	13	0x4ab9a5acf1d298bf3c0662f584bcc362b07460abf110031ff7377ed62330ec58
2999	0x0000000000000000000000000000000000000000	0xa2ab82999742ce4e1482c817cd7ed31b9d22c163	148.3908	21765921.414697087081235615	3921874	30	0x1715ab20831b5ac0c4a0e4a4ce505651ff654c4c7c72ab9b5806596fd3dc841b
3000	0x0000000000000000000000000000000000000000	0x40d1cb3e3f5224075970de8b9ed1d252497ee448	78.407784	21765999.822481087081235615	3921883	62	0x1ee39bee08fefcab53e54fecdde24e6750cffe72823904779a83fd0c5ab24041
3001	0x0000000000000000000000000000000000000000	0xc20ba1f501c6ffe9eeb8df45b3f9d03623aec4a2	3590.1	21769589.922481087081235615	3921920	3	0x71f3173205cee5b05d07e8a91baa3998416b83ee3e89ced94b7e817582910711
3002	0x0000000000000000000000000000000000000000	0xc0a7d5afbadde305c13756c151c150522884c8e7	467.7285004728	21770057.650981559881235615	3921929	1	0x9bc6702ae6495d6bfa8419edf17afb4056fa8d25c8138cf9061dd868f32a57fe
3003	0x0000000000000000000000000000000000000000	0xa1036fe54d6c4b71afd7f94c7547d0f1a11a8bfa	27.093288	21770084.744269559881235615	3921964	51	0x6919d5dee86e1bab4112de75eeaefcdcbb8360f9959b880d38593df495549439
3004	0x0000000000000000000000000000000000000000	0x0aa1c2aebf02362a4d50fee2e44c7afeafe69120	473.8932	21770558.637469559881235615	3921977	3	0xd68ac8df7dcd8176972d0becec03d5d994c7de647d8be06f223761d1e765f1cc
3005	0x0000000000000000000000000000000000000000	0x3d5e249687791c1c3c8377a99d5cbdfbdc62516f	3350.76	21773909.397469559881235615	3921987	12	0x0ba756a923702210a270714f0279586141e827f162b32d33b103bb7686482e42
3006	0x0000000000000000000000000000000000000000	0xf5b96fc090a491c861c601f2b051fae552194aa3	74.1224013	21773983.519870859881235615	3921988	32	0x0000004324ef954a865a6ae23491db9220d0eb57d78c305533456380a5a765ff
3007	0x0000000000000000000000000000000000000000	0xa1036fe54d6c4b71afd7f94c7547d0f1a11a8bfa	4.7868	21773988.306670859881235615	3921989	21	0xf7346d218373e3712a0a7bfb14fb32541ff6d043a69fe13f50c06301c3cdcfa5
3008	0x0000000000000000000000000000000000000000	0x37c1078d34e5cec936f56576992de1206a680344	47.868	21774036.174670859881235615	3922076	44	0xb94d214961f26f28bbb9e84fb48be2a3f3bcaa99cba9ad69f31530b7903fba0f
3009	0x0000000000000000000000000000000000000000	0xedb01c3d8fe622e33fdaa3ad40a08bed1b3b8f25	574.416	21774610.590670859881235615	3922087	12	0x233db91c77d287f129f96700958e822fd32895e57d956007c5a2ac7fcbefbc76
3010	0x0000000000000000000000000000000000000000	0x37c1078d34e5cec936f56576992de1206a680344	89.03448	21774699.625150859881235615	3922106	55	0xe78f1c9a7eca38ac733adea590725f6121ab9de57dfbbe379f40a9fa84110d52
3011	0x0000000000000000000000000000000000000000	0x572201f76133f9b1eddcd660547949ff946c43ee	957.36	21775656.985150859881235615	3922106	57	0x8fb0dbddaaba2a9b6e57b4278343d1aa9537b7e0f6f0fef19c193d64e6cfe135
3012	0x0000000000000000000000000000000000000000	0xcc8d24bb17487162a8bf0ba6ac42f1dc97cc06a7	969.3952119	21776626.380362759881235615	3922114	3	0x1b9595bf44c4e31f25d9fbfd47fd69e82dd48fa9044ee6064e571f33f74ed9ca
3013	0x0000000000000000000000000000000000000000	0xb9a626cf685658b9cd0a3a4ae7055f7e312afc14	1129.6848	21777756.065162759881235615	3922137	17	0x0547caabfe9f38c6a12ebfc33c5c669b0124135724281e577b559df7de2353b4
3014	0x0000000000000000000000000000000000000000	0xc71c40696745155c39e19de22c270d0812fae3f1	957.36	21778713.425162759881235615	3922245	3	0xa6a1fec95fa9a02e7e9c3161889f1e2d80a4611556f5cb7beaba63177e6e6237
3015	0x0000000000000000000000000000000000000000	0x3c4413171be882f3ec7c47e7ec3e8bbd2f2f4237	2978.82564	21781692.250802759881235615	3922249	12	0xa7cbd9e236c957d044e76f7b6ca7545f3bb879a87794aa52143dbee6c4b98747
3016	0x0000000000000000000000000000000000000000	0x6fc52ee1c25128a495de2db8c66f71fe102d2f03	43.0812	21781735.332002759881235615	3922268	71	0xa3bc51f32bb8aaf4c449040704f68775f52b34f534ffe62ef8060fbc30a7b4f9
3017	0x0000000000000000000000000000000000000000	0x2967c551f7b2ad78f9d18a2d3f6c4341049b422d	478.68	21782214.012002759881235615	3922296	9	0x242f509fb31c1186cec9e0d9f18416c21a2ca92abef70ae31a3294ac1b1c2e9c
3018	0x0000000000000000000000000000000000000000	0xf1a2e625404e00683c4a11249dfdb46510af13dd	189.5404161036	21782403.552418863481235615	3922307	14	0x2de8c41d03dc1b8a5bd335f409fac4d3e5676f26e22be55ba737061d63dc0985
3019	0x0000000000000000000000000000000000000000	0x35dd4775d26114e58dcdeb8b82a5551124b917e5	765.888	21783169.440418863481235615	3922339	67	0xdd31a2777cf48f0a799e9c87ec3be83b3876185bca32b57d2131460624d2b41b
3020	0x0000000000000000000000000000000000000000	0x1fc1fc0e588fc30c0f4561e380c7937870df7ad3	9.5736	21783179.014018863481235615	3922340	4	0x650166f7eb2a676adb94057d8b271799f7c483ab22ca85c4d4e6368823c19f01
3021	0x0000000000000000000000000000000000000000	0x8d87a7aff18f0762efdbd65997bd3b78623ed23b	177.1116	21783356.125618863481235615	3922344	32	0xbf908bb506df0d9abbd0ce2c94981bbfecc37670b85c384d1f46d6b276d17a6f
3022	0x0000000000000000000000000000000000000000	0x8b7759c799d46c77478385186db566fcc50f714f	909.492	21784265.617618863481235615	3922376	14	0x29f7cdeef4581a969f035239914f6552cce2ed7d29ee02907c1274b5c0c631f7
3023	0x0000000000000000000000000000000000000000	0x3ab9a674058c2855e8085683bccaf82a7aa76b9f	478.68	21784744.297618863481235615	3922377	23	0x1a1da1ad0b064bb159bbb01192e2b022760ad67a90cd96824f1aac45da0f1c2a
3024	0x0000000000000000000000000000000000000000	0xcbd1afb8b6400675dd08841bc75d05b75cb6b79f	16753.8	21801498.097618863481235615	3922408	22	0x728e7d6853f91cd3636e38d734062681cae608cea736d15264c8dfe24ab008c3
3025	0x0000000000000000000000000000000000000000	0x5677ca94a47ed1b26ab86d7b5594ea4f7ce13a68	0.047868	21801498.145486863481235615	3922451	68	0x3729ae45c0ccb9ddc6440ab192bddda6fa730ffba43256eb194ba45b34ae08fd
3026	0x0000000000000000000000000000000000000000	0x940b1b1d3012c9754c53a83aa884c929c8d6ae7e	957.36	21802455.505486863481235615	3922454	39	0xad920d29a91fdd7977bb5b62a3eea68af7959a973f47c6b99a2860d6458f2360
3027	0x0000000000000000000000000000000000000000	0xb94c431e9b96debb0ceaa2db933cfcb49e04d12c	382.944	21802838.449486863481235615	3922472	20	0x26ef96ba2fa2a012c005c5b12d50c6e4c5ceae09c78aa7212a9299486b0e40e7
3028	0x0000000000000000000000000000000000000000	0x5677ca94a47ed1b26ab86d7b5594ea4f7ce13a68	1675.38	21804513.829486863481235615	3922479	21	0x315f2ba69a06ea9f29b7997959c5fa3723e73b06bb765dbad4d0bf8ca3403e2c
3029	0x0000000000000000000000000000000000000000	0xdccca044fe60da89c5b2c65a29914528a5664865	909.492	21805423.321486863481235615	3922487	82	0x6a4e54fa95cf1ad364b5e5fdadd4252602a17c45cfff07f2d121f5bd44296598
3030	0x0000000000000000000000000000000000000000	0x602b6bcec8c538686d67d3cb5777263206676c6e	478.68	21805902.001486863481235615	3922547	45	0xd0ff278dee3b7290ed7e8dabc6f80d4f759c43c482a3f54e43bc50226d7dda52
3031	0x0000000000000000000000000000000000000000	0xefcb5f6ad1c7510ded1ca7ede854d7cd299223d6	957.36	21806859.361486863481235615	3922547	58	0xaf9bb9683c0dd7226b6f7b260704511bc4f00f7e860ae690f84c52a7155591d7
3032	0x0000000000000000000000000000000000000000	0xc656f15ec86794f762bde48459a75d804a2f0a60	1627.512	21808486.873486863481235615	3922562	84	0x5d48948ba3f89a675a91a8c46307214aa90e0152e35819afc9416db3f2e9b729
3033	0x0000000000000000000000000000000000000000	0xe7ff17c50de51c70e273f94d442b4634ea1b32c7	500.000000322	21808986.873487185481235615	3922622	3	0x04b877e4e991816a8c693b98d35d07b1990666cf7f4106bd5668ffaf71bae681
3034	0x0000000000000000000000000000000000000000	0x155e5d747ddf8e8ce0cf332db6257430f159cafe	57.4416	21809044.315087185481235615	3922640	6	0x0a8a70b590c124c2c15284062ed029d0bab2980ee50d37f2ebb14b416250e97b
3035	0x0000000000000000000000000000000000000000	0x7b71e4c03c3c4d1cbe25241888c81ebd714ad41e	2109.54276	21811153.857847185481235615	3922644	26	0xce63ca309dc13dd0a805afbaeb5ee9de5dbdd511e2b6e0edda7bef02e3572403
3036	0x0000000000000000000000000000000000000000	0xd7aa63105d43160ab80d774dcbca89533dc3f40c	107.703	21811261.560847185481235615	3922657	30	0x94248c86b8733448675df2c8e9df09f8b0c6d7a29f5933f50567856003ec7df5
3037	0x0000000000000000000000000000000000000000	0xc4324edfa8525f7171c391f890b9214c6fb9b202	469.1064	21811730.667247185481235615	3922665	79	0x1f346216b47a3b057054c427b45bb959ac37766defe58eb1d66652f972addea8
3038	0x0000000000000000000000000000000000000000	0xc045d5cc0b65d0799a8283b08b33f457e7fa6e0a	143.604	21811874.271247185481235615	3922686	23	0xc99636fa316d7630bbb373b169c59a6f1302d3a26dc8b2c2af6f5a2f78900689
3039	0x0000000000000000000000000000000000000000	0x148f8f90b924f6d10d82faac57a334b2b75a0ae9	4786.8	21816661.071247185481235615	3922693	8	0xa247ca90882063a3621cd514ce3116517ac5b42de014d3d2a103792d6b2a6170
3040	0x0000000000000000000000000000000000000000	0xb8d5db18bd8101a31cf9a988f5dfd57ebf0f9bb1	957.36	21817618.431247185481235615	3922693	25	0x8c23974b6af43638bf15ec1150ccfc294b5d0c3bc1ec6aa7e52f8841d049c085
3041	0x0000000000000000000000000000000000000000	0xcbda3981b28c3e7159db929b4cf4028cc1401ad3	1292.436	21818910.867247185481235615	3922693	66	0x545cc6d875f3a8968e2ed7c148f1cc1e727075694141f7e9668bbf0b5b5dcf20
3042	0x0000000000000000000000000000000000000000	0xd856667446f570b80f234e07210ca1631657fc79	23.934	21818934.801247185481235615	3922781	6	0xf4b34add20e02a988f78daf3fbb697d8c439217b8319909c1d48d23c99864bf4
3043	0x0000000000000000000000000000000000000000	0xb5b03c79d33d088a28182e2aada636893f69ab6f	6.44040700086	21818941.241654186341235615	3922801	3	0x32b402173058dd8c225ac79ee2034907264d39c09451e57e2d60ed6108b9217a
3044	0x0000000000000000000000000000000000000000	0x95f8ea3e971e7394beda48651fc8db189b0f58f0	88.91911812	21819030.160772306341235615	3922809	15	0x2bd5260421509723cac367e6ed992a67d4591cc05e2538df1d5f3f6bb8ec0c5f
3045	0x0000000000000000000000000000000000000000	0xc046b59484843b2af6ca105afd88a3ab60e9b7cd	478.68	21819508.840772306341235615	3922815	81	0x695ff62e0b2027701a0b41b4d87cca10525323e983cca6303d111ad61c44f125
3046	0x0000000000000000000000000000000000000000	0x835342195322e13f8c8a6318ceb86e7ed8a0a99b	239.34	21819748.180772306341235615	3922818	43	0x34249d5d15a20ce12166a52db46590761fb5878d1744eaf6ec6bea1471a372b5
3047	0x0000000000000000000000000000000000000000	0x835342195322e13f8c8a6318ceb86e7ed8a0a99b	239.34	21819987.520772306341235615	3922818	64	0xe18836e75be8a19b267f9894bcf1982c104511745e2949d03a01ae2e2747b4d0
3048	0x0000000000000000000000000000000000000000	0x1db477697da39872a052dcfff4cdb2dcb363bbba	1914.72	21821902.240772306341235615	3922826	46	0xa4e353386d1e6d6ca42663ba8906da2dec62b5edbcafa15e8515d40e7eddfb3a
3049	0x0000000000000000000000000000000000000000	0xd856667446f570b80f234e07210ca1631657fc79	0.47868	21821902.719452306341235615	3922840	24	0x4c10f04854738c207ba77a926d829cc443a39a264fab5a583611658bbf0a9c8d
3050	0x0000000000000000000000000000000000000000	0x9a4896f3e436e1cf1239cc36cc72e4ff727b2971	335.076	21822237.795452306341235615	3922842	4	0xfeff3f95d10693fb1f3a89808d0984f05251884706d787337f00ec1be15fb725
3051	0x0000000000000000000000000000000000000000	0x8a94025a7137ed78980027f2b5d30e4e221aeafe	157.9644	21822395.759852306341235615	3923028	24	0x5a3e3acc5eda2a676cb9e0b5c05c4fb40952c9e842d223780ef4b3ee7e58f5ad
3052	0x0000000000000000000000000000000000000000	0x173da0696da297358a28bc91b5e8687bde18c519	153.1776	21822548.937452306341235615	3923031	37	0x394b01576e6ab33f149b8fe9b3e4c7c45de1326f298fc270979e1733dac0cf49
3053	0x0000000000000000000000000000000000000000	0x0f644133c38f8af5e1495a4e1df9c8a68475b607	478.68	21823027.617452306341235615	3923070	15	0x67f13cf879cca27364a2158ebe8830dda277c85b9bc4a2f7205bd602d1bf456d
3054	0x0000000000000000000000000000000000000000	0x555f70318364a056a9c2a6c5b26af0a42bced510	1436.04	21824463.657452306341235615	3923073	58	0x5683a2cfac969bde617f57c8b304808528b3bd7e2ca2c46e909d5157dd597423
3055	0x0000000000000000000000000000000000000000	0x3fbc56d3dc53375f5a0b5412f299b452404b5150	718.02	21825181.677452306341235615	3923086	22	0xc70c9270132c830626c3ea0c75c3d653fe7ac5214bc55d879b9459bcd26e7a29
3056	0x0000000000000000000000000000000000000000	0x4b1cae2be2c1745bf878fd6cde09e8bab2d2c3db	14.3604	21825196.037852306341235615	3923102	12	0xbf8b98e4ec233f48080372f5647020ed04e12dc56f39a69f7c6c8b095c2f2f23
3057	0x0000000000000000000000000000000000000000	0xb574be92f6d2c9e65de8879b071fc1dd2161c488	478.68	21825674.717852306341235615	3923117	17	0x8ff8a180bd235e6338bea88b1b18fe5f77a06ff6a24d861d77a94e6c39b02341
3058	0x0000000000000000000000000000000000000000	0x31e58b4e52cbd9b0cdd9cb943459380bfc0b1757	119.67	21825794.387852306341235615	3923146	0	0xe1710e651f5fc4a71c9832fa6c382fcaf9df7c52acbea43fa00c3ca67d59754b
3059	0x0000000000000000000000000000000000000000	0xdefe91e19a327688dd874068ea0bc042f9cf4622	2393.4	21828187.787852306341235615	3923179	9	0x970fb08b4f22225782208bdcd3dfc2a2f6146e92f64ccf604a4e1b0f1f854318
3060	0x0000000000000000000000000000000000000000	0xf55a6c9231f7428bfc25997b39d5ebd87b8ea44e	239.34	21828427.127852306341235615	3923199	6	0x6637c52b498cf5da77c498669e38b71b6938882e1a9ca2d17b48b22122d8cda8
3061	0x0000000000000000000000000000000000000000	0x0a03d2d715c5263ba83593db7f3697b96575d53d	43.0812	21828470.209052306341235615	3923225	0	0xa29156017934d1a3e75e8b3a9dbd4bc5c36bebc8dea34b2a7b24b4e63955b6d2
3062	0x0000000000000000000000000000000000000000	0xd0df04d86763ab4b21800b115923d6d6d1e3826c	47.868	21828518.077052306341235615	3923240	19	0x453a7572113619a172a58c371402e2ad6de280aad8d6aa2b13742e40832fbc0b
3063	0x0000000000000000000000000000000000000000	0x003dd2f57a2f1f107b0ce01f4282cb1929754dfc	478.68	21828996.757052306341235615	3923271	25	0x97a91277a30f9e714d19d7efe63011c4eb174ab93e250d7ff5bfc48688d25eb9
3064	0x0000000000000000000000000000000000000000	0x2ffc55146d7a9934315f0a4403fb05e309b6e612	291.9948	21829288.751852306341235615	3923278	41	0x09a1da6cbb6634b3aaccf2390a56dcd8cdc39fb97d1ca396e8d0b4d7d45c1f6f
3065	0x0000000000000000000000000000000000000000	0xd1c786e6ed805f552a5619766f799984a9f1c03f	9573.6	21838862.351852306341235615	3923291	0	0xf00bf6427ba61cdaf90a5f60aa676e4cafdecae93da92b8268f64a615566df36
3066	0x0000000000000000000000000000000000000000	0xdb3b515d7fd7c0a4acb5408c39695e0e507aa633	1485.487644	21840347.839496306341235615	3923291	37	0x722aee77f14e818b219e92aeb2a62f30c4a5e592afac8e90dfff0809f2c31ca9
3067	0x0000000000000000000000000000000000000000	0x7e9b57f5e3e83fe98dbc5d27cd8b9267ca1037d8	473.8932	21840821.732696306341235615	3923297	68	0xdfe4094148f80f2a17f2f69b787a7842773ef07cf469ff35e85cdd8437f7e9ea
3068	0x0000000000000000000000000000000000000000	0xd4a12fb506d2129e3e5575301b5544c06eaee7d3	18189.84	21859011.572696306341235615	3923312	37	0x29dd8a44b0ba781d3943a1728da95e88613c033e3460c854765b13e3d786ba5d
3069	0x0000000000000000000000000000000000000000	0xc673dadcca43ad4ff7f3c99419fd35e1578ad1ec	11967	21870978.572696306341235615	3923363	7	0x17fc2cbd0f2c54864777af59a2e1b5a4b79b0c6133eb3e73ce8375d67f7c8602
3070	0x0000000000000000000000000000000000000000	0x3fb8bfc3f2b962e812e720034e2e9bfc193f1636	478.68	21871457.252696306341235615	3923429	0	0x611760c820aac0b3b10107a6faa9e795d6e3783525e0bb18debadfd73581c5ad
3071	0x0000000000000000000000000000000000000000	0x1e6c6cd7614f8189fcc46d3bcc8281f6be236c32	956.88132	21872414.134016306341235615	3923437	8	0xfb72dda40ee98c52d8b32339a220639cb22ac3b9bb6335b038758640c70bb8dc
3072	0x0000000000000000000000000000000000000000	0x502051395ffd9847659bbe395a1200c39774a564	7180.2	21879594.334016306341235615	3923447	11	0xcfb39554dfb75dc7a21d045497dc5be2be169f93ff289f23db6e69bb51504197
3073	0x0000000000000000000000000000000000000000	0x650ab7317b125d0f6a6dc70437d13d570b87ebf9	957.36	21880551.694016306341235615	3923464	6	0x3d9fc396e457612c0fbec4e341eb9ca23827cc402bbc7671f408d2aede30e4c3
3074	0x0000000000000000000000000000000000000000	0x9ccc06491ec14761bc2e95933485d9de608f1836	1579.644	21882131.338016306341235615	3923483	37	0xb6cdd4011f4e5f92fa09cc09a82a5fe52c3a375cc6ce6943a0e1560465d38de0
3075	0x0000000000000000000000000000000000000000	0x2e6f2776a28870c2b493a21efcb81082a1baa082	69.4226636184	21882200.760679924741235615	3923495	39	0x7bb6a70a03f946d3d64866eacd3fa176491f8180b14802a9c8fd9850e708d567
3076	0x0000000000000000000000000000000000000000	0xda095fbdf0e21932a8a24c8deae2dbb3ee362951	239.34	21882440.100679924741235615	3923498	65	0x1c67cd2f35576cb34c128bf4334df9472494efe9cf3e2fb13b06c51c11fcdaa1
3077	0x0000000000000000000000000000000000000000	0xbcd58013960ee61ad47c4db97875405fe824c77a	936.947668601135838084	21883377.048348525877073699	3923502	15	0xcd8ec5c55ebc63696b3bdb49830a81863d1146dc1a4fea339d3d29bf2d4095f7
3078	0x0000000000000000000000000000000000000000	0x4f3f66920d2321b5c51ae379cf1a243405dea1ad	1436.04	21884813.088348525877073699	3923504	18	0x0c68dd0c80f9c079c561f6c9125bb9aa64b2d16799488f72a0bd831d5306c3be
3079	0x0000000000000000000000000000000000000000	0xb94c431e9b96debb0ceaa2db933cfcb49e04d12c	284.8146	21885097.902948525877073699	3923513	87	0xd6e01cebc50831dfaebffb0e89bd7ef77103de29bf72848921237880d6b72aa4
3080	0x0000000000000000000000000000000000000000	0xa22438f8c8ba4f08a9a3c857b2687cc1a890ee30	478.68	21885576.582948525877073699	3923521	44	0xc5cb5f45a97d356e08e4515e06f45a2780a294e87fd9093f9b57bcd81bee4222
3081	0x0000000000000000000000000000000000000000	0xd42a5179c25a35ca266220cfd4ea52eacac746e6	574.416	21886150.998948525877073699	3923524	44	0x028dbe1e4c40654afae9b5f74c897a8e91fc039b37dac7dffe879ec7cc35f5b7
3082	0x0000000000000000000000000000000000000000	0x21e6022e1b77e40381d7e55b333427bb361cda10	4550.55797675088	21890701.556925276757073699	3923574	38	0x5cd82e0d2ec7d55e053b70c760bec9870831d5fd8f175446f8498ddc066c5838
3083	0x0000000000000000000000000000000000000000	0x88f4caed86783f1bbad900fe41f35b0046760535	718.02	21891419.576925276757073699	3923575	6	0x5cef2881f224d928eda64f9887be108263e7e8dfc87a7273d02845c41f83c94e
